ようやく今日の分の仕事が終わった	今天的工作终于结束了
さて体力が少し余っているな…少し身体を動かすか？	还有些体力…是稍微活动一下身体。
それとも今日はベッドで休もうか？	还是今天在床上休息？
一人で自分の戦い方を見直しながら武器を振った……	一个人一边重新审视自己的战斗方式一边挥舞武器……
%ANAME(MASTER)%はそのまま朝まで続けた	%ANAME(MASTER)%就这样一直持续到早上
皆が寝静まり始めた深夜、%ANAME(MASTER)%も寝ようとベッドに横になった	在大家开始安静入睡的深夜，%ANAME(MASTER)%也要睡了，躺在床上
%ANAME(対象)%を妻に迎えてからは必ず毎日同じベッドで寝ている	自从娶了%ANAME(対象)%为妻之后，每天都睡在同一张床上
だが隣には妻は居ない、普段なら先に床に就いている筈だが……	但是妻子没有在旁边，平时应该是最先上床的……
きっと夢の世界に行っているのだろうと考え、%ANAME(MASTER)%は蝋燭の灯を消して一人で寝ることにした	想着一定是去了梦的世界吧，%ANAME(MASTER)%就把蜡烛的熄灭，一个人先睡了
ぼんやりと蝋燭の火が部屋を照らしている……おかしい、蝋燭の火は確かに消したはずだが	烛光朦胧地照着房间……奇怪的是，蜡烛确实是被熄灭了
「ふふっ%ANAME(MASTER)%ったら、これで起きちゃうなんて眠りが浅いですねぇ良い夢見れませんよ？」	「呵呵，%ANAME(MASTER)%真的是，就这样醒了的话，这么浅的睡眠可是做不到好梦哦？」
目を覚まし声のする方へ向くと、そこには挑発的に微笑んでスカートをたくし上げた%ANAME(対象)%がベッドの傍に立っていた	睁开眼睛朝着发出声音的方向，在那里%ANAME(対象)%嘲讽般地微笑着举起裙子站在床的旁边
「…セックス好きの女って……嫌い？」	「…讨厌……渴望做爱的女人吗？」
%ANAME(対象)%は%ANAME(MASTER)%の頬に手を当てて耳元でそう囁いた	%ANAME(対象)%用手抚摸着%ANAME(MASTER)%的脸颊，在耳边轻声说到
%ANAME(MASTER)%は頬に当てられた手に自らの手を重ね、自身の思いを伝えた	%ANAME(MASTER)%将自己的手放在正抚摸自己脸颊上的手上，传达了自己的想法
「……じゃあ…いいよね」	「……那么…开始吧吧」
表情を変える事無く%ANAME(対象)%は手を離し、寝そべる%ANAME(MASTER)%の上に立つ	面色不变的%ANAME(対象)%松开手，站在睡着的%ANAME(MASTER)%上
そのまま%ANAME(対象)%はスルスルと衣服を脱ぎ落とし、艶っぽい紫に綺麗な刺繍レースをあしらったベビードール姿になる	%ANAME(対象)%就这样脱下衣服，漏出带着紫色蕾丝边的情趣内衣
ピンっと張った乳首が透けて見え、下着の上からでも欲情しきっているのがわかるほどの愛液で蜜壺が濡れている……	可以看到她紧绷的乳头，透过被打湿的内衣也能看出秘穴因为情欲已经溢出的爱液
%ANAME(対象)%は%ANAME(MASTER)%の手を握り、濡れた蜜壺をなぞらせてきた	%ANAME(対象)%握着%ANAME(MASTER)%的手，伸向湿了的秘穴
ネットリとした愛液が%ANAME(MASTER)%の指と指の間でヌチャヌチャと音を立てて糸を引いている……	粘糊糊的爱液在%ANAME(MASTER)%的手指之间发出粘糊糊的声音还拉着丝……
「もう……こんなになっちゃったの♥　んちゅっ……♥」	「已经……变成这样了吗♥嗯……♥」
%ANAME(MASTER)%が勃起したのを見てとると、%ANAME(対象)%は互いの舌を交わらせる程の濃厚なキスをしてきた	看到%ANAME(MASTER)%勃起的时候，%ANAME(対象)%开始深吻并将舌头纠缠起来
「%ANAME(MASTER)%は動かなくていいわ♥」	「%ANAME(MASTER)%不要动呢♥」
皆が寝静まり始めた深夜、%ANAME(MASTER)%も寝ようとベッドに横になると隣に%ANAME(対象)%が横たわっていた	在大家开始安静入睡的深夜，%ANAME(MASTER)%也要睡了，躺在床上，旁边躺着一只%ANAME(対象)%
「ふふっ、今日も……ね♥」	「呵呵，今天也……对吧♥」
%ANAME(対象)%はすでに艶っぽい%SPLIT_RAND("紫/黒/赤/緑/青/白", 1)%に綺麗な刺繍レースをあしらった%SPLIT_RAND("ベビードール/オープンブラ/ビスチェ/スリップ", 1)%姿だ	%ANAME(対象)%穿上艳丽的带有漂亮刺绣花边的%SPLIT_RAND("紫/黒/赤/緑/青/白", 1)%色的%SPLIT_RAND("背带裙睡衣/开胸睡衣/紧身女胸衣/衬群", 1)%
ピンっと張った%SPLIT_RAND("乳首/クリトリス", 1)%が透けて見え、下着の上からでも欲情しきっているのがわかるほどの愛液で蜜壺が濡れている……	粉红稚嫩的%SPLIT_RAND("乳首/阴蒂", 1)%隐隐约约显露出来，透过内衣能明显看见秘穴已经被爱液打的透湿
%ANAME(対象)%は%ANAME(MASTER)%の背に手をまわし、身体を押し付けるように抱き着いてきた	%ANAME(対象)%把手环在%ANAME(MASTER)%背后并紧紧搂住，用身体紧紧贴在他的背上
「すぅーっ♥　はぁぁ♥　すぅーっ♥　はぁぁ♥」	「哇♥哈哈♥哇♥哈哈♥」
%ANAME(MASTER)%の耳の裏に鼻をあてて深呼吸をする%ANAME(対象)%、呼吸の度に身体をビクッと震わせている	将鼻子贴在%ANAME(MASTER)%耳后进行深呼吸的%ANAME(対象)%，每次呼吸都会全身颤抖
身体が震える度に%ANAME(MASTER)%のペニスはヌチャヌチャと音を立てて%ANAME(対象)%の濡れた蜜壺を摩っていく……	每当身体颤抖的时候，%ANAME(MASTER)%的阴茎就会发出粘糊糊的声音，摩擦着%ANAME(対象)%湿了的秘穴……
「だめ……我慢デキない♥　んちゅっ……♥」	「不行……忍耐不住了♥嗯~……♥」
「舌出して♥　ほら♥　んむっ♥　ちゅ、れろっ……♥」	「伸出舌头！♥瞧♥嗯，嗯♥啊~，等下……♥」
言われるまま舌を出すと、%ANAME(対象)%はその舌先に自らの舌先を絡ませ舌裏や天井まで舐める	再舌头纠缠后说完这句话，%ANAME(対象)%就开始把舌尖缠到对方的舌头，舔到舌低和嘴巴上表层
「あむっ……ぢゅるるるっ…んっ♥」	「啊……嗯…嗯♥」
%ANAME(対象)%は%ANAME(MASTER)%の舌を咥え、フェラチオをするように音を立てて吸い始める	%ANAME(対象)%叼着%ANAME(MASTER)%的舌头，然后发出如同口交一样的声音吸吮着
そのまま更に%ANAME(MASTER)%に抱きつきながら%ANAME(対象)%は淫らに首を動かす	%ANAME(対象)%就这样抱住%ANAME(MASTER)%，淫荡地摇晃着头
しばらくしてようやく%ANAME(対象)%は%ANAME(MASTER)%の舌から舌先を離した	过了一会儿，%ANAME(対象)%终于从%ANAME(MASTER)%的舌头上松开了嘴
互いの舌先は透明で粘っこい糸をつぅーと垂らし繋がっている……	彼此的舌头垂着透明而粘稠的线，连接在一起……
「はぁぁ♥　ねぇ……%ANAME(MASTER)%♥」	「哈哈♥呐……%ANAME(MASTER)%♥」
%ANAME(対象)%は%ANAME(MASTER)%のペニスを手で優しく愛撫しながら耳元で囁く	%ANAME(対象)%用手温柔地爱抚着%ANAME(MASTER)%的阴茎，在耳边轻声细语
「おちんちん♥　勃てて♥♥♥　いっぱいエッチしよ♥♥　気持ちよくなっちゃお♥♥♥」	「小鸡鸡♥又勃起了呢♥♥♥来继续做爱吧♥♥心情就会快乐了呢♥♥♥」
「好き♥　%ANAME(MASTER)%大好き♥♥　愛してる♥」	「喜欢♥最喜欢%ANAME(MASTER)%了♥♥我爱你♥」
「ほら触って♥♥　オマンコ♥　グッチョグチョなの♥　%ANAME(MASTER)%のおちんちん欲しいの♥♥♥」	「快操我♥♥阴穴~♥是个好男人♥我想要%ANAME(MASTER)%的小鸡鸡♥♥♥」
「気持ちよくなっちゃお♥　いっぱいエッチしちゃお♥」	「真快乐啊~♥做爱了很多次呢♥」
「孕ませて♥♥　いっぱい♥♥♥　気持ちよくして♥♥♥　ほら♥　おちんちん勃てて♥♥」	「让我孕育吧~♥♥满满的~♥♥♥心情舒畅起来~♥♥♥瞧♥小鸡鸡勃起了♥♥」
「エッチ♥♥　気持ち良～い♥♥　エッチしよ♥　ねっ♥♥♥」	「真色情呢~♥♥好快乐~♥♥来做爱吧~♥对吧♥♥♥」
「%ANAME(MASTER)%のおちんちんで♥♥　いっぱい突いて♥♥　いっぱい出して♥♥♥」	「被%ANAME(MASTER)%用小鸡~鸡♥♥戳得满满的~♥♥得到很多呢~♥♥♥」
「好き♥♥　好き♥♥　好き♥♥♥　エッチしたいの♥♥　%ANAME(MASTER)%♥♥♥　大好きっ♥♥♥」	「喜欢♥♥喜欢♥♥喜欢♥♥♥做爱啥的~♥♥%ANAME(MASTER)%♥♥♥最喜欢了~♥♥♥」
%ANAME(対象)%の囁きに%ANAME(MASTER)%が勃起すると、%ANAME(対象)%は互いの舌を交わらせる程の濃厚なキスをしてきた	%ANAME(MASTER)%在%ANAME(対象)%的耳语中勃起，%ANAME(対象)%开始深吻并纠缠彼此的舌头
%ANAME(対象)%は下着から乳首を露出させ%ANAME(MASTER)%の口元へ近付けた	%ANAME(対象)%从内衣露出乳头，靠近%ANAME(MASTER)%的嘴边
「ねぇ……吸って♥」	「呐……请吸着~♥」
%ANAME(MASTER)%は%ANAME(対象)%の淡いピンク色の乳輪に舌を這わせる…	%ANAME(MASTER)%让舌头舔上了%ANAME(対象)%淡粉色的乳晕上…
「もぅ……♥　……ふふっ♥」	「嗯……♥　……呵呵呵♥」
そのまま乳輪だけをねちっこく攻め続ける%ANAME(MASTER)%	%ANAME(MASTER)%就那样只盯着乳晕持续进攻
「んっ♥　……ふっー♥」	「嗯♥　……呼~♥」
既に%ANAME(対象)%の乳首はピンっと張り詰め、%ANAME(MASTER)%の舌先による愛撫への期待に満ちている…	%ANAME(対象)%的乳头已经紧紧地贴着，充满了对%ANAME(MASTER)%舌尖能爱抚的期待
切なげな声で呟いている%ANAME(対象)%	%ANAME(対象)%无法再忍受胸闷而呻吟起来
その姿を見て%ANAME(MASTER)%は乳輪ばかりを責めていた舌先を乳頭に移した	看到这个样子，%ANAME(MASTER)%将舔舐乳晕的舌头移到了乳头上
「あっ♥♥♥　そんな急に♥♥♥♥」	「啊~♥♥♥太突然~♥♥♥♥」
%ANAME(MASTER)%は乳頭を舌先で舐め絞ったり、舌先でちょっぴり触れさせた	%ANAME(MASTER)%用舌尖舔舐乳头，用舌尖稍微碰了一下
「あはっ♥……はっ…んっ……くあっ…♥」	「啊哈哈♥……啊…嗯……啊啊…♥」
そのたび%ANAME(対象)%は腰を浮かせ感じている…	每次%ANAME(対象)%都会挺起腰来…
そこへ%ANAME(MASTER)%は固くなった乳首を甘噛みしつつチュパチュパと音をたてて吸った	%ANAME(MASTER)%一边咬着变硬的乳头一边吧嗒吧嗒地吸着
「あぁん♥♥　そんな赤ちゃんみたいに♥♥」	「啊啊啊♥♥像婴儿样呢♥♥」
「ふふっ♥　良いですよ♥　おっぱい好きなのよね♥」	「呵呵呵♥好啊♥喜欢乳房吧♥」
%ANAME(MASTER)%が口を離すと、%ANAME(対象)%が互いの舌を交わらせる程の濃厚なキスをしてきた	当%ANAME(MASTER)%松口的时候，%ANAME(対象)%吻住了彼此的舌头
「私に任せて♥　いっぱい気持ち良くしてあげる♥♥」	「交给我吧♥让你快乐起来~♥♥」
「バキバキに勃起した孕ませおちんちん♥　私のねっ…とりオマンコでドピュ♥ドピュ♥させてあげる」	「用勃起的小鸡鸡让我怀孕吧~♥就这样…直接射在里面♥biubiubiu~地♥我会让你尽情地射的~」
「好き♥　いっぱい愛し合いましょ♥　と～っても濃厚な種付け孕ませセックスしましょ♥」	「喜欢吧♥那让我们好好地感受相爱的快感吧♥话虽如此也别忘要进行浓厚的配种做爱哦~♥」
「えっちしましょ♥　気持ちいいえっち♥」	「让我看看♥好舒服啊~♥」
「ふふっ♥　危険日子宮でおちんちんジュポジュポさせてあげる♥♥♥」	「呵呵呵♥在正处于危险日的我的子宫给咕噜咕噜地灌满吧♥♥♥」
%ANAME(対象)%は%ANAME(MASTER)%のペニスを手に取りしごき始めた	%ANAME(対象)%开始拿起%ANAME(MASTER)%的阴茎
「ふふっ、手の中でびくんびくんしてる♥」	「哼哼，还在我手中扑哧扑哧地响呢♥」
丹念にペニスをしごいていく%ANAME(対象)%	专心地撸阴茎的%ANAME(対象)%
右手でペニスをしごきながら左手で袋を優しい手つきで触っている	右手捋着阴茎，左手摸着睾丸
強すぎず弱すぎず、程よい%ANAME(対象)%の奉仕に%ANAME(MASTER)%は徐々に射精へと向かっていく	不太强也不太弱，%ANAME(対象)%用适当的力量来的侍奉使%ANAME(MASTER)%射精
「射精したくなったら……♥　いつでもしていいわ♥　受け止めてあげる♥」	「如果想射精的话……♥随时都可以♥我会接住的~♥」
「ふふっ♥　ビクビクしちゃって可愛いわね……えいっ♥」	「呵呵呵♥战战兢兢的好可爱啊……嗯，嗯♥」
ぴんっと指で軽くペニスを弾く	用手指轻轻地弹阴茎
痺れる様な快感に思わず%ANAME(MASTER)%は仰け反る	%ANAME(MASTER)%因为麻痹般的快感，不受控制地仰起了头
「あらっ♥　ちょっと痛かったかしら♥　んっー……そうでもないようね♥」	「哎呀♥有点疼吗♥嗯……不是那样的吧♥」
そう言って%ANAME(対象)%は手の動きを再開させた	这样说着，%ANAME(対象)%又开始动手撸
「ふふっ♥　随分と大きな子供になっちゃったわねぇ……♥」	「呵呵呵♥变成了相当大的孩子呢……♥」
%ANAME(MASTER)%は%ANAME(対象)%の太ももに顔を乗せ、彼女の胸を弄っている	%ANAME(MASTER)%把脸贴在%ANAME(対象)%的大腿上，玩弄着她的胸部
一方で慈愛の表情を浮かべながら丹念に竿をしごいていく%ANAME(対象)%	%ANAME(対象)%一边浮现出慈爱的表情，一边细心地撸着阴茎
「射精したくなったら♥　いつでもしていいわ♥　受け止めてあげる♥」	「想要射精的话♥随时都可以♥我会接住的♥」
%ANAME(MASTER)%はそのまま%ANAME(対象)%の手に射精した	%ANAME(MASTER)%就那样射精在%ANAME(対象)%的手中
「あーあー、手のひらがドロドロですねぇ♥」	「啊啊，手掌好粘啊♥」
手や顔にかかった精液を%ANAME(対象)%は奇麗に舐めとっていく。	%ANAME(対象)%把手和脸上的精液舔个精光。
もう味にも慣れてしまったのか、表情には欲情の色が窺えた…	大概已经习惯了味道吧，从表情上可以看出渴求的面色…
「底無しですね……♥」	「真是射不尽啊……♥」
%ANAME(対象)%は、射精直後にも関わらず手の中で再び固くなり始めた%ANAME(MASTER)%の陰茎を惚けながら眺めている……	%ANAME(対象)%一边欣赏着刚射精不久又开始变硬的%ANAME(MASTER)%的阴茎一边眺望着……
「…ぁ……あはっ♥」	「…啊……啊哈哈♥」
%ANAME(対象)%は飛び出した精液を片手で受け止め、掌には一杯の精液で出来た水たまりが完成する	%ANAME(対象)%用一只手接住飞出的精液，用一杯精液形成的水洼完成了
それを%ANAME(対象)%は一気に飲み干し、残った分を奇麗に舐めとっていった	%ANAME(対象)%一口气喝干了，把剩下的部分干净地舔了下去
それでも足りないのか上目遣いで手淫しながら、物欲しそうに次の射精を強請った…	尽管如此还是不够吧，一边用眼睛向上看，一边手淫，一边贪婪地请求下一次射精…
「…ふふっ……♥」	「…呵呵……♥」
手や顔を奇麗に掃除した後、%ANAME(対象)%はペニスを扱いて残り汁を舐めとる	把手和脸上的精液清洁干净后，%ANAME(対象)%舔阴茎剩下的汁液
未だに勃起する%ANAME(MASTER)%の肉棒を見て、その逞しさに見惚れていた…	看到还勃起的%ANAME(MASTER)%的肉棒，对她的坚强无比着迷…
%ANAME(対象)%は%ANAME(MASTER)%のペニスを舐め始めた	%ANAME(対象)%开始舔%ANAME(MASTER)%的阴茎
「んむっ♥　ちゅ、れろっ……」	「嗯，嗯♥喂，等等……」
「…じゅる…っ…んっんんぅ…♥」	「…来吧…嗯…嗯…♥」
%ANAME(対象)%は%ANAME(MASTER)%の弱いところを的確に攻めてくる	%ANAME(対象)%准确地攻击了%ANAME(MASTER)%的弱点
「ちゅぽっ……ふふっ、いつでも口の中に射精していいのですよ？」	「中穗……呵呵，什么时候都可以射精到嘴里哦？」
「んむっ……ちゅるっ、じゅるるる……」	「嗯……嗯，知道了……」
%ANAME(MASTER)%に抱きつきながら%ANAME(対象)%は淫らに首を動かす	%ANAME(対象)%一边抱住%ANAME(MASTER)%一边淫荡地摇着头
速く精液が欲しいのか上目遣いで射精を切望している	应该是想快一点得到精液，眼睛都向上翻了起来，一心想要快些射精
自らイマラチオをするように%ANAME(対象)%は涙目になりながら高速で首をストロークさせる	%ANAME(対象)%主动做着深喉，流着眼泪，一边快速地前后吞吐着
%ANAME(MASTER)%が気持ち良くなるのを最優先している為か、涎を零すのも構わず振り続ける	可能是是因为要让%ANAME(MASTER)%感受快感放在最优先的位置，流着泪也不要紧，继续坚持做着
その成果あってか、高まる%ANAME(MASTER)%の射精感はすぐに早まっていった…	正因为有了这样的成果，%ANAME(MASTER)%很快就想射精了
速めに首を動かしながらも空いた手でタマを揉んで%ANAME(対象)%は熱い肉棒を奉仕する。	%ANAME(対象)%快速地摇着头，用空手揉着睾丸，侍奉着炽热的肉棒。
頬側にペニスを外から浮き出るのが分かるくらいに擦りつけ、%ANAME(対象)%は楽しそうに笑った…	擦到脸颊侧的阴茎从外面露出来，%ANAME(対象)%开心地笑了…
%ANAME(MASTER)%はそのまま%ANAME(対象)%の口に射精した	%ANAME(MASTER)%就那样射精在%ANAME(対象)%的口中
「…んっ……ごくっ……はぁー…っ…♥」	「…嗯……非常……哈…嗯…♥」
「んっ…んっ……はぁっ……ごくっ…ごくっ♥」	「嗯…嗯……哈……极…极，非常♥」
「コクッ……ごくんっ♥……ふぁっ…んっ……んんっ…」	「浓香……非常♥……啊啊啊…嗯……嗯…」
「…じゅるっ……んっ…ぢゅー……ごきゅっ……♥」	「…熟……嗯…嗯……哦，嗯……♥」
「……ごくんっ…♥…ぢゅるるるっ……んっ……♥」	「……非常…♥…嗯……嗯……♥」
肉棒を%ANAME(対象)%の喉まで突き入れると、そのまま射精する。	把肉棒刺进%ANAME(対象)%的喉咙，就这样射精。
直接喉に流し込まれる液体でむせないよう%ANAME(対象)%は必死に耐える。	为了不让直接流入喉咙的液体呛到，%ANAME(対象)%拼命忍耐。
全て飲みきれたことを頭を撫でて褒めてやると、涙を堪えていた%ANAME(対象)%はすぐに笑顔になった…	抚摸着脑袋并夸赞到全部喝下去时，忍住眼泪的%ANAME(対象)%马上变成了笑容…
待ちかねていたかのようにペニスから吐き出された精液を、%ANAME(対象)%は喉を鳴らして飲み始めた。	%ANAME(対象)%像是在等得不耐烦似的，从阴茎吐出的精液，在喉咙里开始喝了。
%ANAME(対象)%は喉の渇きを癒すようにザーメンを受け止め続ける。	%ANAME(対象)%为了治愈喉咙的干渴继续接受着精液。
射精があらかた終わると、おかわりを強請るように上目遣いで未だ勃起する肉棒を咥え直した…	射精大致结束后，像是要求再来一碗一样，用眼睛向上看，再次叼起勃起的肉棒…
射精が終わると%ANAME(対象)%はペニスを引き抜き、口に溜まった新鮮な精液を吐き出そうとする。	射精结束后，%ANAME(対象)%拔出阴茎，打算吐出嘴里积存的新鲜精液。
しかし、それを吐き出すことが何故か出来ず、ゴクンと喉を鳴らして胃に収めてしまった。	但是，不知为何吐不出来，扑通一声的喉咙响了起来，收进了胃里。
不機嫌そうな表情を取り繕ってはいたが…頬を赤らめて欲情しているのが明らかだった。	装作不高兴的表情…显然脸红了脸还贪得无厌。
尿道に残った分を掃除させようと%ANAME(対象)%の顔に肉棒を近づければ、一瞬の戸惑いの後に口へ含んだ…	想让她打扫尿道里剩下的部分，就把肉棒靠近%ANAME(対象)%的脸，只有那一瞬的困惑之后她就含在了嘴里…
口に出され続ける%ANAME(MASTER)%の精液を%ANAME(対象)%は欲情した顔で飲み干す。	%ANAME(対象)%用贪婪的表情将口边流出的%ANAME(MASTER)%精液全部喝干
尿道に残った分も勢いよく吸い出して、全て胃の中に収める。	尿道里残留的部分也会很好地被吸出来，全部收纳在胃里。
その行為に陶酔し、欲情する%ANAME(対象)%は再びペニスを咥え奉仕を続けた…	陶醉于这种行为，发情地%ANAME(対象)%再次叼着阴茎继续服务…
ペニスから吐き出されるザーメンを飲み干し、%ANAME(MASTER)%の余韻も治まった。	喝完阴茎吐出的精液，%ANAME(MASTER)%的余韵也平息了。
だが、それでも%ANAME(対象)%はストロークを続け、次の射精を所望している…	但是，尽管如此，%ANAME(対象)%还是继续做着，期待着下一次射精…
%ANAME(対象)%は%ANAME(MASTER)%のペニスを胸で挟みしごきはじめた	%ANAME(対象)%用胸口开始夹住%ANAME(MASTER)%的阴茎
「…………んっ…あ…っ…♥…」	「…………嗯…啊…嗯…♥…」
「…ぁ…♥」	「…啊…♥」
%ANAME(対象)%は寝そべった自分に跨る%ANAME(MASTER)%のペニスを谷間に導いた。	%ANAME(対象)%把跨坐在%ANAME(MASTER)%的身上，阴茎引导到自己如同山谷一样的胸间
打ち付ける度に顔に姿を現す亀頭を、%ANAME(対象)%は愛おしく舐め上げた…	每次打到龟头打在脸上时候，%ANAME(対象)%很可爱地舔了一下…
%ANAME(MASTER)%は%ANAME(対象)%の溢れんばかりの双丘の谷間に肉棒を差し込むと、両手で抑え込んで腰を振り始めた。	%ANAME(MASTER)%把肉棒插入%ANAME(対象)%那丰满的胸间，两手压住开始摆动腰。
%ANAME(対象)%は合わせるように爆乳で上下にストロークしながら、谷間から苦しそうに顔をだす亀頭を唇と舌で愛撫する…	%ANAME(対象)%配合着用爆乳上下抚摸，从勉强用嘴巴与舌头安抚着胸谷中的龟头…
%ANAME(対象)%は豊満な乳でペニスを挟むと、慣れた動きでパイズリを始めた。	%ANAME(対象)%用丰乳夹着阴茎，用习惯了的动作开始了阴茎。
谷間に隠れた肉棒を両腕で胸を圧迫しながらタプンタプンと音鳴らしてピストンする。	用双臂压迫着隐藏在山谷里的肉棒，啪嗒啪嗒地响着活塞运动。
視覚的に興奮させるその光景に、%ANAME(MASTER)%は射精感を高めていく…	在这种视觉上令人兴奋的景象中，%ANAME(MASTER)%的射精感不断提高…
胸で%ANAME(MASTER)%のペニスを挟むと、丁度いい形でフィットする。	胸前夹着%ANAME(MASTER)%的阴茎，尺寸正好合适。
溢れんばかりの双丘を軽く持ち上げ圧迫させ、ペニスを前から挿入してそのまま身体をゆっくと動かす。	轻轻地抬高溢出的双丘使之压迫，从前面插入阴茎使身体晃动。
%ANAME(MASTER)%は%ANAME(対象)%の肩を掴みセックスするように腰を振って縦パイズリを堪能する。	%ANAME(MASTER)%抓着%ANAME(対象)%的肩膀摆动着腰，再做爱中
手による圧迫加減でまるで本番をしているかのような快感が、%ANAME(MASTER)%の興奮を高めていく	由于手的压迫，仿佛像是在真正插入性交一样的快感，使%ANAME(MASTER)%变得兴奋起来
%ANAME(対象)%は柔かな胸で%ANAME(MASTER)%のペニスを挟み、まずは軽く上下していく。	%ANAME(対象)%用柔软的胸脯夹住%ANAME(MASTER)%的阴茎，首先轻轻地上下移动。
今度は左右交互に上下していく動きに変え、変える度に双丘をペニスに押し付け刺激する。	然后变成左右交替上下的动作，每次变换都会刺激着被压在双丘上的阴茎。
徐々に腰を動かしてく%ANAME(MASTER)%を見て、気を良くした%ANAME(対象)%はさらに刺激を強めていった…	看着慢慢活动着腰的%ANAME(MASTER)%，变得舒服起来的%ANAME(TARGET)%进一步加强了刺激…感
%ANAME(MASTER)%はそのまま%ANAME(対象)%の胸に射精した	%ANAME(MASTER)%就那样射精在%ANAME(対象)%的胸中
「…っ…あんっ♥」	「…嗯…嗯♥」
勢いよく射精して吐き出されたザーメンを、%ANAME(対象)%は胸で全て受け止める	%ANAME(TARGET)%用胸接住了被猛地射出的精液。
コーティングが終わると、先ほど以上に滑りが良くなった胸で肉棒の奉仕を再開した…	涂抹结束后，比刚才更滑的胸部再次开始了肉棒的侍奉…
大量の精液で汚された胸を%ANAME(対象)%は嬉しそうに眺め、指で撫でて絡め付いた精液を舐めとっていく	%ANAME(TARGET)%高兴地看着被大量精液污染的胸部，用手指抚摸后，舔着缠绕在手上的精液。
%ANAME(対象)%が舐めている間に、%ANAME(MASTER)%は乳首に亀頭を押し付けて残りの分を出そうとする	在%ANAME(対象)%舔舐期间，%ANAME(MASTER)%把龟头压在乳头上，想把剩下的部分射出来
舐めとりが終わると、ペニスを口に含んで残りを吸いあげていった…	舔完后，用嘴里含住阴茎吸了剩下的东西…
%ANAME(MASTER)%は絶頂寸前に豊満な乳房を掴み、柔らかな圧迫感に包まれて谷間の中で射精した	%ANAME(MASTER)%在顶峰前抓住丰满的乳房，被柔软的压迫感包围在谷间中射精
谷間に溜まった精液を胸で上下交互に動かし、肌をザーメンでベトベトにさせていく	用胸上下交替运动涂抹谷间积存的精液，用精液使皮肤变得黏糊糊的
暫くして胸を広げると、広がった精液が糸を引いて谷間を汚していた…	过了一会儿打开双乳，发现展开的精液拉丝污染了胸谷…
%ANAME(対象)%は%ANAME(MASTER)%のペニスを自らの性器でしごきはじめた	%ANAME(対象)%用自己的生殖器开始玩弄%ANAME(MASTER)%的阴茎
「きっ…気持ちっ…あっ……あんっ…っ……そこぉっ…♪」	「切…心情如何…啊……嗯…嗯……那里有…♪」
「…っ…ひゃっ…いいっ……もっ…とぉっ…♥」	「…嗯…哎呀…好……以…嗯…♥」
「はぅっ…♪……っ…あっ……きもち…いっ……♥」	「呋呜…♪……嗯…舒服……哈啊…啊……♥」
「ぁっあっぁっああっ……んぁあっ！…♥」	「啊啊啊啊啊啊……嗯啊啊！…♥」
「…あっ…ぁんっ…はっはっ…♥」	「…啊…啊啊…哈哈…♥」
「当たっ…て…っ…ああぁっ！…あんっ…はぁあぁっ！♥」	「中…手…嗯…啊啊啊啊！…嗯…啊啊啊！♥」
「っひゃんっ………ぁ…あっあっぁあっ♪」	「哎呀………啊…啊啊啊啊啊♪」
「ふぁっ！……んっ…んっあっ……ぁ…あはっ♥」	「啊啊！……嗯…嗯……啊…啊哈哈♥」
「……つぁっ！……し…しびれっ……ふぁっ♥」	「……啊啊！……做…麻痹了……啊啊啊♥」
愛液で濡れきった%ANAME(対象)%の秘所に%ANAME(MASTER)%は性器同士を合わせ、素早く擦っていく。	%ANAME(MASTER)%把性器对准被爱液濡湿了的%ANAME(TARGET)%的秘所，快速地摩擦。
入口を強く刺激されつつ、%ANAME(対象)%もなんとか動いて当たる力を強めていく…	在入口被强烈刺激的同时，%ANAME(TARGET)%也努力地动着身体，加强冲击的力道…
%ANAME(対象)%は%ANAME(MASTER)%に跨って、艶めいた腰つきで動いていく。	%ANAME(対象)%跨上%ANAME(MASTER)%，以艳丽的姿态行动着。
%ANAME(MASTER)%に身体を委ね、%ANAME(対象)%は%ANAME(MASTER)%を抱き寄せるように腕を首に回す。	把身体交给%ANAME(MASTER)%，%ANAME(対象)%抱住%ANAME(MASTER)%，把手臂转动到脖子上。
%ANAME(MASTER)%に跨り、%ANAME(対象)%は愛液で滑りが良くなった秘所を%ANAME(MASTER)%のに擦り付ける。	%ANAME(TARGET)%跨坐在%ANAME(MASTER)%身上，用被爱液浸湿的滑溜溜的秘所摩擦着%ANAME(MASTER)%的身体。
うねりながら身体を動かし、伝わってくる快感に%ANAME(対象)%は淫らな声を上げていた…	不断起伏的身体，传来的快感使%ANAME(TARGET)%发出了淫荡的声音
%ANAME(MASTER)%はそのまま%ANAME(対象)%の股へと射精した	%ANAME(MASTER)%就那样射精在%ANAME(対象)%的胯下
「あーあー、お股がドロドロですねぇ♥」	「啊啊啊，你的腿好黏啊♥」
股にかかった精液を%ANAME(対象)%は手で奇麗に舐めとっていく	%ANAME(対象)%用手干净地舔着大腿上的精液
「底無しですか貴方……？」	「无底洞吗你……？」
%ANAME(対象)%は、射精直後にも関わらず股の間で再び固くなり始めた%ANAME(MASTER)%の陰茎を半ば呆れながら眺めている……	%ANAME(対象)%虽然刚射精不久，但在胯间又开始变硬了，半呆呆地看着%ANAME(MASTER)%的阴茎……
手や股を奇麗に掃除した後、%ANAME(対象)%はペニスを扱いて残り汁を舐めとる	手和大腿清洁干净后，%ANAME(対象)%用阴茎舔剩下的汁液
「ふふっ♥　それじゃっ♥」	「呵呵呵♥那么，再见♥」
%ANAME(対象)%はギンギンに勃起した%ANAME(MASTER)%の肉棒を騎乗位の体勢で膣内に飲み込む	%ANAME(対象)%用骑乘位的姿势将勃起的%ANAME(MASTER)%的肉棒吞入阴道内
%ANAME(対象)%の膣内に%ANAME(MASTER)%のペニスが音を立てて入っていく	%ANAME(MASTER)%的阴茎发出声音进入%ANAME(対象)%的阴道内
%ANAME(MASTER)%は%ANAME(対象)%の腰を掴んで思い切り突き上げた	%ANAME(MASTER)%抓住%ANAME(対象)%的腰狠狠地推了上去
「はぁんっ♥　ちょ、っと♥　……いきなり突き上げないで……んぁあっ♥♥」	「哈啊♥等一下♥　……不要突然顶上去……嗯啊啊♥♥」
%ANAME(MASTER)%は腰を激しく上下させ連続で%ANAME(対象)%の膣内を貫く	%ANAME(MASTER)%腰部激烈地上下连续贯穿%ANAME(対象)%的阴道内
「ま、まって♥　%ANAME(MASTER)%っ♥　……もう少しゆっくり……ぁあっ♥」	「等一下♥%ANAME(MASTER)%♥　……再慢一点……啊啊啊♥」
「やっ♥　すご、い……奥まで、届いてるぅ……♥」	「哎呀♥好厉害……送到了里面……♥」
%ANAME(対象)%は%ANAME(MASTER)%に跨り乱れ喘いでいる	%ANAME(対象)%跨越%ANAME(MASTER)%乱喘息着
「%ANAME(MASTER)%のおちんちん、熱くて、硬くてぇっ……♥」	「%ANAME(MASTER)%的小鸡鸡，又烫又硬……♥」
淫らに腰を振る%ANAME(対象)%に合わせように、%ANAME(MASTER)%も下から肉棒を突き刺す	为了配合淫荡地摆动着腰的%ANAME(対象)%，%ANAME(MASTER)%也从下面刺进肉棒
「んんっ♥　……ぁあんっ♥　出してっ♥♥　精液っ♥　出してっ♥♥♥」	「嗯，嗯♥　……啊啊啊♥拿出来♥♥精液♥拿出来♥♥♥」
コツンと子宮口に亀頭が当たる感触に悲鳴のような声で%ANAME(対象)%はよがる	龟头碰在子宫口上的触感，让%ANAME(対象)%发出悲鸣般的声音
妊娠の危険などお構いなしに、熱い中出しを求めていった…	不顾怀孕的危险，要求趁热中出…
「この体位、私がリード出来るから結構好きかも……♥」	「这个体位，因为我能领导所以可能很喜欢……♥」
「ほら、これなんかどう？ うりうりっ♥」	「看，这个怎么样？售货员♥」
主導権を得られタガが外れたのか、%ANAME(MASTER)%を押さえつけて激しいピストン繰り返していく	或许是获得了主导权，束缚解除了吧，抓住了%ANAME(MASTER)%，反复进行激烈的活塞运动
%ANAME(対象)%は腰をぐるぐると回転させ始め、前後左右、上下と不規則に動かし、%ANAME(MASTER)%の快感を増大させる	%ANAME(対象)%开始扭动腰，前后左右，上下不规则地扭动，来增加%ANAME(MASTER)%的快感
「んっ♥　……ふふっ♥　ねぇ、また膣内で大きくなってますよ？　出したいんでしょう？　んっー♥」	「嗯♥　……呵呵呵♥呐，阴道内那东西可又变大了哦？想射出来吧？嗯♥」
%ANAME(対象)%は荒い息遣いをしながら欲情しきった笑みを浮かべ、自ら腰を動かし肉棒を子宮口に当てて中出しを誘う	%ANAME(対象)%一边喘着粗气，一边露出充满欲望的笑容，自己动着腰，把肉棒放在子宫口中引诱出
「ははぁん、もっと気持ち良くさせてあげるわね……♥」	「哈哈，我会让你更舒服的……♥」
流石にやられっぱなしも癪なので下から突きあげてやると、嬉しそうに喘いだ…	就算被骂了也会很生气，所以从下面把他推上去，他看起来很开心地喘息着…
「はぁんっ♥　ちょ♥　っと♥　……いきなり突き上げないで……んぁあっ♥♥」	「哈酱♥等一下♥突然♥　……不要突然推上去……嗯啊啊♥♥」
「はっ♥　ぁあっ♥　%ANAME(MASTER)%っ……♥」	「哈哈♥啊啊啊♥%ANAME(MASTER)%……♥」
「あぁっ♥　……気持ちいい、%ANAME(MASTER)%……♥」	「啊啊啊♥　……好舒服，%ANAME(MASTER)%……♥」
雄の遺伝子を欲しがる子宮に応えるように、そのピッチも短く激しくなる	就像是为了回应想要雄性遗传因子的子宫一样，其间距也变得短而激烈
「んぁあっ♥　やっ♥　だめ、気持ち良過ぎて……もう♥　……ぁああっ♥♥」	「嗯啊啊♥哎呀♥不行，太舒服了……已经♥　……啊啊啊啊♥♥」
ゾクゾクと身体を震わせる%ANAME(MASTER)%を笑顔で見下ろして、射精を促していった…	笑着俯视着颤抖着身体的%ANAME(MASTER)%，催促着射精…
トロトロの肉壷に捉えられたペニスを激しいグラインドで腰を振る%ANAME(対象)%	%ANAME(TARGET)%用黏糊糊的肉壶摇晃着被吸住的阴茎
「あっ♥　ぁあっ♥　%ANAME(MASTER)%、好き、大好きぃっ……♥」	「啊♥啊啊啊♥%ANAME(MASTER)%、喜欢、最喜欢……♥」
%ANAME(MASTER)%の上で乱れながら愛を叫んでくる%ANAME(対象)%	在%ANAME(MASTER)%上一边混乱一边呼喊着爱的%ANAME(対象)%
%ANAME(MASTER)%もお返しに愛を囁きつつ腰を突き上げる	%ANAME(MASTER)%也作为回礼在低声私语着爱的同时抬起了腰
%ANAME(MASTER)%を犯しているような感覚に欲情して、%ANAME(対象)%はさらに肉棒を膣内で刺激する	%ANAME(対象)%更是在阴道内刺激肉棒
「は、ぁあんっ♥　も、もう、だめ、イッちゃいそう……♥」	「哈，啊♥已经，不行了，好像快到了……♥」
「はっ♥　んぁっ♥　ぁぁぁあああっ……♥♥」	「哈哈♥嗯啊啊♥啊啊啊啊啊……♥♥」
「膣内っ……こすれっ…♥……あぁっ…あっあっあっはぁんっ♥」	「阴道内……摩擦…♥……啊啊…啊啊啊哈哈♥」
「…っ…ひゃっ…いいっ……ぅあぁっ！……♥」	「…嗯…哎呀…好……嗯！……♥」
「…ぅあっ…ぁっ…膣内で…コツンっ…てっ……♥」	「…嗯…啊…在阴道内…一个劲地…嗯……♥」
「当たっ…て…っ♥…ああぁっ！…あんっ…はぁあぁっ！♥」	「中…手…嗯♥…啊啊啊啊！…嗯…啊啊啊！♥」
「んぁあっ……はっ……ぃ…いっ…ぱい……出し…っはぁぁんっ…♪」	「嗯啊啊……啊……嗯…一…嗯……出…哈哈哈…♪」
「…ッ気持ち……ぁっ…よすぎ…♥……イっちゃっ…ひゃあぁあっ♥」	「…心情……啊…太好了…♥……糟了…哎呀♥」
「んんっ…！？いや、少しお腹の子がびっくりしたようなので…」	「嗯…！？不，肚子里的孩子好像有点吃惊…」
%ANAME(対象)%はお腹を擦っている……	%ANAME(対象)%在擦肚子……
「こらっ、妊娠中くらい我慢しなさい」	「喂，忍耐一下怀孕期间吧」
%ANAME(対象)%は、少し怒った様子で頬を膨らませている……	%ANAME(対象)%带着有些生气的表情鼓起了脸颊……
「ふぅっ…、止めてと…言ったのに…っ…」	「呼…停下来…我说过了…嗯…」
%ANAME(対象)%は、身体を震わせて膣内射精の余韻に浸っている……	%ANAME(対象)%身体颤抖，沉浸在阴道内射精的余韵中……
「膣内でっ…出て…♥……あぁっ…赤…ちゃん……っ♥」	「阴道内…出来…♥……啊啊…红色…酱……嗯♥」
「…妊娠…♥……しちゃうのぉっ…っ……♥」	「…怀孕…♥……我会做的…嗯……♥」
「いっぱい出しましたね…♥♥」	「出了很多呢…♥♥」
「ふぅっ…、熱っ……蕩けそう……♥」	「呼…、热……快要溶化了……♥」
「………♥…ぁあっ…沢山…遺伝子…はっ…流れて…きたっ♥」	「………♥…啊啊啊…很多…遗传因子…啊…流…来，来♥」
「…受精……っ…しちゃった……みたい…っ……♥」	「…受精……嗯…搞砸了……好像…嗯……♥」
「…今日は…ぁっ…危険…日っ……っ…いっぱい…出してっ♥」	「…今天是…啊…危险…日……嗯…满满的…拿出来♥」
「…ぁあっ……出てるぅ……ぃ…種付け……されちゃった…ぁんっ…♪」	「…啊啊……出来了……嗯…配种……被打了…啊啊…♪」
「…んっ……あはっ♥……いっぱい出たぁ……」	「…嗯……啊哈哈♥……出了很多……」
「子宮に……♥……いっぱい…ちょうだいっ♥」	「子宫……♥……满满的…我要♥」
「子宮にっ……貴方のドロドロ精液…♥……いっぱい…射精してっ♥」	「进入子宫……你的粘稠精液…♥……满满的…射精吧♥」
「…な…膣内にっ…♥……射精して………っ…あぁっ…♥」	「…呐…在阴道内…♥……射精………嗯…啊啊…♥」
「いいの…っ……ああっ…っ……気持ち…いい…っ……♥！」	「可以吗…嗯……啊啊…嗯……心情…好的…嗯……♥！」
「ほらぁっ……んっ…私を……ぁ…奪ってみせてっ♥」	「你看……嗯…把我……啊…让我抢给你看♥」
「…ッ気持ち……ぁっ……♥……イっちゃっ…ひゃあぁあっ♥」	「…心情……啊……♥……糟了…哎呀♥」
射精を始めようとする%ANAME(MASTER)%の腰に脚を絡め、%ANAME(対象)%は中出しを強要させる	将脚缠在打算开始射精的%ANAME(MASTER)%的腰上，%ANAME(対象)%强行要求中出
限界まで膨れ上がった肉棒から放たれる精液で、子宮を犯される快楽に%ANAME(対象)%は震えた	从膨胀到极限的肉棒中放出的精液，被侵犯子宫的快乐吓得%ANAME(対象)%颤抖
孕ませられる雌の悦びに浸りながら、%ANAME(対象)%は遺伝子で満ちたお腹を愛おしそうにさすった…	一边沉浸在被孕育的雌性的喜悦中，%ANAME(対象)%一边抚摩着充满遗传因子的肚子…
「ぁんっ…♥…膣内で出しましたね♥…これは”出来る”かもしれませんよ…？」	「啊啊…♥…是在阴道内取出的吧♥…这可能是"可以"的吧…？」
降りてくる子宮を感じながら、濃厚な種付けを求めてピストンを続けた…	一边感受着子宫落下的感觉，一边追求浓厚的配种，一边继续进行活塞运动…
%ANAME(対象)%は精液で満たされた下腹部を擦っている……	%ANAME(対象)%擦着充满精液的小腹……
「…だけど、この程度で満足しないのでしょう？」	「…但是，这种程度就不满足了吧？」
淫らに腰を振る%ANAME(対象)%に合わせるように、%ANAME(MASTER)%も下から肉棒を突き刺す	为了配合淫荡地摆动着腰的%ANAME(対象)%，%ANAME(MASTER)%也从下面刺进肉棒
妊娠の危険などお構いなしに、%ANAME(対象)%の膣は熱い中出しを求めていった…	不管妊娠的危险等，%ANAME(対象)%的阴道都在灼热的状态下要求取出…
狭い膣内で肉棒を絞めつけ、%ANAME(対象)%は長いストロークで腰を縦に振っていく	在狭窄的阴道内勒紧肉棒，%ANAME(対象)%用长的一击直摇腰
%ANAME(対象)%は目をうっとりと細めると秘裂から零れ出た白濁液を指で掬うと、そのまま舐めとった……	%ANAME(対象)%把眼睛眯得很细，用手指捞起从秘密中流出的白色浑浊液，就那样舔着……
%ANAME(MASTER)%は交尾の最終目的である種付けをするべく、亀頭で子宮口をこじ開けて遺伝子を吐き出した	%ANAME(MASTER)%为了进行交配的最终目的的配种，用龟头撬开子宫口吐出了遗传因子
精子たちは当人たちの思いに応えるべく、必死に卵子に向けて泳ぎだす	精子们为了回应当事人的想法，拼命地向卵子游去
子を成すことを望む%ANAME(対象)%は、愛する人の種が無事受精することを祈った…	希望生孩子的%ANAME(対象)%，祈祷着所爱之人的种子能够平安受精…
「ふぅっ…、出て…るぅ……♥」	「呼…出来…嗯……♥」
欲望のまま放たれる%ANAME(MASTER)%の遺伝子を、%ANAME(対象)%は発情した雌のように子宮で受け止める	%ANAME(対象)%像发情的雌性一样，用子宫接受了被欲望释放的%ANAME(MASTER)%的遗传因子
蹂躙するがの如く子宮の中を飛びはねとぷとぷと満たす感覚に%ANAME(対象)%もまた快感に浸る	如同蹂躏一般在子宫中弹跳，充满了扑通扑通的感觉，%ANAME(対象)%也沉浸在快感中
射精が終わるまでの間、二人は痙攣しながら身体を押し付け合った…	在射精结束之前，两人一边痉挛一边将身体推给对方…
妊娠のリスクを伴うというのに、%ANAME(対象)%は一切の抵抗なく膣内射精を受け止めた	伴随着妊娠的风险，%ANAME(対象)%毫无抵抗地接受了阴道内射精
小さな子宮に治まり切らない白濁液は、溢れ返って膣内を汚し始める	小子宫无法完全治愈的白浊液，开始溢出污染阴道内
暫くの間%ANAME(対象)%は子宮の熱さに震え、射精の余韻に浸る%ANAME(MASTER)%を抱きしめた…	短暂的%ANAME(対象)%因为子宫的热度而颤抖，抱住沉浸在射精余韵中的%ANAME(MASTER)%…
「ふふっ……お疲れ様…♥」	「呵呵……辛苦了…♥」
覆いかぶさったまま腰を激しくピストンさせ、高いカリにゴリゴリ抉られる膣壁の快感に%ANAME(対象)%も耐え切れず嬌声を上げる	捂着腰剧烈地扭动着臀部，阴道壁被高高的龟头剜去的快感，让%ANAME(对象)%无法忍受，娇声叫了起来。
%ANAME(対象)%はギシギシと揺れるベッドに身を預け、%ANAME(MASTER)%の首に腕を回して恋人のように全てを任せる	%ANAME(対象)%把身体靠在摇摇晃晃的床上，将手臂转动到%ANAME(MASTER)%的脖子上，像恋人一样把一切交给对方
打ち込まれる甘悦によって激しく乱れ、上げる余力もなくなった腕でシーツを掴み、%ANAME(MASTER)%の腰に足を絡めて膣内出しを促す…	由于被打入的甘悦而激烈混乱，用没有余力提高的手臂抓住床单，脚缠在%ANAME(MASTER)%的腰上促使阴道内露出…
「…いっぱい♥……幸せ…」	「…满满的♥……幸福…」
%ANAME(対象)%を四つん這いにさせると、%ANAME(MASTER)%はそのまま膣内を貫くように腰を打ち付け始めた	让%ANAME(対象)%四个趴着，%ANAME(MASTER)%就那样开始打起腰来贯穿阴道内
獣の交尾のような体勢に雌の本能が目覚めたのか、%ANAME(対象)%の声は理性を失い妖艶なものになってく。	雌的本能从兽的交尾般的姿势中觉醒了吗，%ANAME(対象)%的声音失去了理性变成了妖艳的东西。
部屋に響く肉を打つ音に興奮を高めながら、二人の行為は徐々に速度を速めていった…	在房间里响起的敲击肉的声音中，两人的行为逐渐加快了速度…
%ANAME(対象)%は、お返しとばかりに騎乗位で腰を淫らに動かし始めた	%ANAME(対象)%为了回礼，开始用骑乘位淫荡地活动腰
%ANAME(対象)%は声を荒げつつも%ANAME(MASTER)%の肉棒を覚えるように、根元まで飲み込む度に膣内の形を%ANAME(MASTER)%のモノへと合わせていく	%ANAME(対象)%的声音虽然粗暴，但为了记住%ANAME(MASTER)%的肉棒，每次吞到根部都会把阴道内的形状和%ANAME(MASTER)%的东西配合起来
心では%ANAME(MASTER)%に謝りながら、身体は相性の良い%ANAME(MASTER)%を選んでしまい、更なる快楽を求めて腰を振りたくった…	在心里向%ANAME(MASTER)%道歉的同时，身体选择了投缘的%ANAME(MASTER)%，为了寻求更大的快乐而扭动了腰…
互いに限界が近い。繋がった二人は何も言わずに抱き合ってラストスパートをかける	彼此界限相近。连接在一起的两个人什么都不说，互相拥抱，最后冲刺
子宮口はとっくに口を開いており、その無防備な子宮に向かって肉欲に塗れた精汁をぶちまけた	子宫口早就张开了嘴，向那个毫无防备的子宫里倒上了沾满肉欲的精液
%ANAME(対象)%は一段と大きい嬌声を上げて身を震わせると、膣壁を狭くさせてペニスから一滴残らず精液を搾り取ろうとする	%ANAME(対象)%发出更大的娇声震动身体，将阴道壁变窄，从阴茎上一滴一滴地榨取精液
射精が終わるまで二人は自然と口づけを交わし、心地よい余韻に浸っていた…	在射精结束之前两人自然地接吻，沉浸在愉快的余韵中…
絶頂寸前の%ANAME(MASTER)%は後ろから%ANAME(対象)%の腕を引っ張り、先ほどよりも激しく肉棒を打ち込み続ける	即将绝顶的%ANAME(MASTER)%从后面拉着%ANAME(対象)%的手臂，比刚才更加激烈地继续打肉棒
亀頭で子宮口をこじ開けていく感触に最高潮の興奮を感じながら、快楽に堕ち淫らな雌と化した%ANAME(対象)%に種付けを果たした	在龟头撬开子宫口的触感中感受到了最高潮的兴奋，同时也为快乐堕落为淫荡的雌性化的%ANAME(対象)%做了配种
根本まで挿入され膨張した肉棒。絶頂で収縮する膣壁。吐き出された精子たちは唯一の逃げ場である子宮へと雪崩を打って入り込む	插根膨胀的肉棒。绝顶收缩的阴道壁。被吐出的精子们向唯一的逃避场所——子宫袭来雪崩
%ANAME(対象)%は子宮が満たされていく感覚を覚え、女として最高の快感と幸福を味わった…	%ANAME(対象)%感受到了子宫被填满的感觉，感受到了作为女人最棒的快感和幸福…
もう射精が近いというのに%ANAME(対象)%は主導権を握ったまま、バチュバチュと音を立てながら妖艶な腰つきで腰を振り続ける	虽然射精已经很近了，但是%ANAME(対象)%却掌握着主导权，啪嗒啪嗒地响着，用妖艳的腰继续挥着腰
%ANAME(MASTER)%は耐え切れずにそのまま膣内に射精したが、しかし%ANAME(対象)%は動きを止めない	%ANAME(MASTER)%无法忍受就那样射精在阴道内，但是%ANAME(対象)%无法停止活动
腰を下ろす度に絶頂でエラを張った亀頭が大量の精液を押し上げ、子宮内へと送り込む	每次坐下的时候，龟头都会在顶峰张开腮帮子，将大量的精液推上去，送到子宫内
満タンでないと満足できない%ANAME(対象)%は、射精が終わった後も精液を搾り取ろうとピストンを続行した…	不加满就无法满足的%ANAME(対象)%，在射精结束后为了榨取精液而继续使用活塞…
…何度目かの射精を子宮で受け止め、出ている間にも%ANAME(対象)%は動きを止めることはない	…子宫接受了几次射精，出来的时候%ANAME(対象)%也不会停止活动
狭い膣内で射精している肉棒を絞めつけ、%ANAME(対象)%は長いストロークで腰を縦に振っていく	把在狭窄的阴道内射精的肉棒勒紧，%ANAME(対象)%用长的一击直摇腰
貪欲に潤いを求める子宮に従い、どんどんピッチも短く激しく淫らになる	随着贪欲追求滋润的子宫，间距越来越短、激烈、淫荡
強すぎる快楽に何度も射精する%ANAME(MASTER)%を%ANAME(対象)%は笑顔で見下ろして、さらに射精を促していった…	%ANAME(TARGET)%笑着俯视着在过于强烈的快乐中多次射精的%ANAME(MASTER)%，并且催促着射精…
…%ANAME(対象)%の膣内があまりに気持ちいいのか、%ANAME(MASTER)%は絶えず射精を繰り返す	…是不是%ANAME(対象)%的阴道内太舒服了，%ANAME(MASTER)%不断重复射精
精液と愛液でトロトロの肉壷に捉えられたペニスを、まだまだ欲しいと激しいグラインドで腰を振り続ける	被精液和爱液变得黏糊糊的肉壶里抓住阴茎，在激烈的冲刺中继续摆动着腰
%ANAME(MASTER)%を犯している状況に恍惚の笑みを浮かべ、%ANAME(対象)%はさらに肉棒を膣内で刺激す。	在被%ANAME(MASTER)%侵犯的情况下露出了恍惚的笑容，%ANAME(対象)%进一步在阴道内刺激肉棒。
既に降りている子宮を亀頭の接触で感じながら、さらなる濃厚な種付けを求めてピストンを続けた…	在龟头接触到已经降下的子宫的同时，为了寻求更浓厚的配种而继续进行活塞运动…
…長く行為を続け、絶頂を何度もした二人ではあるが、止める気配は一向になく%ANAME(対象)%は腰を振り続ける	…两人持续了很长一段时间的动作，虽然已经多次达到了高潮，但却丝毫没有停止的迹象，%ANAME(対象)%继续挥着腰
目の前で淫らに腰を振る%ANAME(対象)%に魅せられ、%ANAME(MASTER)%はされるがままにペニスから射精を次々に吐き出していく	被在眼前淫荡地摆动着腰的%ANAME(対象)%所吸引，%ANAME(MASTER)%就这样从阴茎不断地吐出射精
一度身体を下す度に鈍い水音がなり、接合部からは入りきらない精液が溢れ出てくる	每次身体接触都会发出微弱的水声，从交合处溢出了无法进入的精液
しかしそれでも物足りないのか、%ANAME(対象)%はピストンを繰り返し新しい精液を求めていった…	但是即使这样也还是觉得有点欠缺，%ANAME(対象)%反复用活塞追求新的精液…
%ANAME(対象)%はギンギンに勃起した%ANAME(MASTER)%の肉棒を騎乗位の体勢で尻穴に飲み込む	%ANAME(対象)%用骑乘位的姿势把银勃起的%ANAME(MASTER)%的肉棒吞进了屁股洞里
%ANAME(対象)%の尻穴に%ANAME(MASTER)%のペニスが音を立てて入っていく	%ANAME(MASTER)%的阴茎发出声音进入%ANAME(対象)%的屁股孔
「はぁんっ♥　 ちょ、っと♥　……いきなり突き上げないで……んぁあっ♥♥」	「哈酱♥等一下♥　……不要突然推上去……嗯啊啊♥♥」
%ANAME(MASTER)%は腰を激しく上下させ連続で%ANAME(対象)%の尻穴を貫く	%ANAME(MASTER)%的腰激烈地上下连续地穿过%ANAME(対象)%的尻穴
「ま、まって♥　%ANAME(MASTER)%っ♥……もう少しゆっくり……ぁあっ♥」	「等一下♥%ANAME(MASTER)%♥……再慢一点……啊啊啊♥」
「%ANAME(MASTER)%のが、熱くて、硬くてぇっ……♥」	「%ANAME(MASTER)%的，又热又硬……♥」
コツンとS字直腸に亀頭が当たる感触に悲鳴のような声で%ANAME(対象)%はよがり熱い中出しを求めていった…	龟头碰上S字直肠的感觉时发出悲鸣般的声音，%ANAME(対象)%在灼热中寻求出…
%ANAME(対象)%は腰をぐるぐると回転させ始める	%ANAME(対象)%开始转动腰部
前後左右、上下と不規則に動かし、%ANAME(MASTER)%の快感を増大させる	前后左右，上下不规则地活动，增加%ANAME(MASTER)%的快感
「んっ……ふふっ、ねぇ、またお尻の中で大きくなってますよ？」	「嗯……呵呵，呐，又在屁股里变大了呢？」
%ANAME(対象)%は荒い息遣いをしながら欲情しきった笑みを浮かべ、自ら腰を動かし肉棒をS字直腸に当てて中出しを誘う	%ANAME(対象)%一边喘着粗气，一边露出充满欲望的笑容，自己动着腰，把肉棒贴在S字直肠上，引诱她从中出来
%ANAME(対象)%は自分の胸とクリトリスを弄りながら積極的に腰を動かしている	%ANAME(対象)%一边玩弄着自己的胸部和剪发一边积极地活动着腰
%ANAME(対象)%のもう片方の胸に手を伸ばし、乳首を弄りながら%ANAME(MASTER)%も腰を動かす	将手伸向%ANAME(対象)%的另一边的胸，一边玩弄乳头一边%ANAME(MASTER)%也动了腰
「んぁあっ♥ やっ♥　だめ、気持ち良過ぎて……もう♥　……ぁああっ♥♥」	「嗯啊啊♥ 哎呀♥不行，太舒服了……已经♥　……啊啊啊啊♥♥」
%ANAME(MASTER)%を犯しているような感覚に欲情して、%ANAME(対象)%はさらに肉棒をS字直腸で刺激する	%ANAME(対象)%感觉到自己犯了%ANAME(MASTER)%，于是用S字直肠刺激肉棒
%ANAME(MASTER)%はそのまま%ANAME(対象)%の直腸へと射精した	%ANAME(MASTER)%就那样射精了%ANAME(対象)%的直肠
「ははぁん、またお尻の穴に出すのですか…？？」	「哈哈，又放在屁股洞里了吗…？？」
「どうせいつもの事…」	「反正总是这样…」
「一緒に……♥？」	「一起……♥？」
%ANAME(対象)%は止めとばかりにイったばかりのアヌスをさらに強く締め上げ、射精と同時に再び絶頂に達した……	%ANAME(対象)%更加强烈地勒紧了刚刚被阻止的阿努斯，在射精的同时再次达到了顶峰……
「ははぁん、またお尻の穴に出すのですか…？」	「哈哈，又放到屁股洞里了吗…？」
「イッて良いですよ…この変態さん♥」	「可以的…这个变态♥」
%ANAME(対象)%は止めとばかりにアヌスをさらに強く締め上げた……	%ANAME(対象)%欲罢不能般地将阿努斯紧紧地系上……
「は…んっ……！貴方のせいですっかりお腹が灼けたようね…♥」	「哈…嗯……！都怪你，我的肚子都烧焦了…♥」
%ANAME(対象)%の尻穴は既に門としての役割を放棄し、ぽっかり開いたまま精液を垂れ流している……	%ANAME(対象)%的屁股孔已经放弃了作为门的作用，滴答着精液……
「すっかり、下の口でも飲み干せるようになってしまったわね…♥」	「已经完全可以用下面的嘴喝光了呢…♥」
%ANAME(対象)%は精液を撹拌して音を立てるお腹を、満足気に擦っている……	%ANAME(対象)%把搅拌精液发出声音的肚子，用满足的心情摩擦着……
「あぅ…っ、尻に…力がはいらない………」	「啊…嗯，屁股上…力量不足………」
アナルセックスで緩んだ%ANAME(対象)%の肛門から精液が零れ落ちた……	由于肛门性关系松弛了的%ANAME(対象)%的肛门中精液流出了……
「はぅ……っ、尻穴が灼けそう……」	「哈……嗯，屁股孔好像要被灼烧了……」
%ANAME(対象)%は、粘液が腸内を満たしていく感覚に快楽を覚えつつあるようだ……	%ANAME(対象)%似乎正在从粘液充满肠内的感觉中逐渐感受到快乐……
%ANAME(MASTER)%は%ANAME(対象)%を押し倒し、%ANAME(対象)%の秘裂にペニスを突き入れ腰を動かした…	%ANAME(MASTER)%推倒了%ANAME(対象)%，将阴茎刺入%ANAME(対象)%的秘裂，动了腰…
「この姿勢だと……私があなたを好きに出来ないから、ちょっと残念ね」	「这个姿势的话……我不能喜欢你，有点遗憾」
%ANAME(対象)%に好きにされるのもそれはそれでいいが、いつまでもマグロでいるわけにもいかない	被%ANAME(対象)%喜欢也是可以的，但也不能永远是金枪鱼
%ANAME(MASTER)%は腰を激しく動かし始める	%ANAME(MASTER)%开始剧烈地活动腰
「んぅっ♥　はげ、しっ♥　やぁんっ♥」	「嗯♥秃子，嘘♥哎呀♥」
%ANAME(対象)%が手をこちらに伸ばしてきた	%ANAME(対象)%向这边伸出手
その手を握ってあげると%ANAME(対象)%も握り返してくる	握住那只手的话%ANAME(対象)%也会回来
%ANAME(MASTER)%も%ANAME(対象)%と繋がっている幸福を噛み締めながらスパートをかけた	%ANAME(MASTER)%也和%ANAME(対象)%紧紧相连，一边咀嚼着幸福一边冲刺
「んぁあっ♥　%ANAME(MASTER)%っ♥　%ANAME(MASTER)%っ♥」	「嗯啊啊♥%ANAME(MASTER)%♥%ANAME(MASTER)%♥」
「んぁ♥、ぁぁあああ～～～っ♥♥♥」	「嗯啊♥、啊啊啊～～♥♥♥」
「んっ♥……%ANAME(MASTER)%のがっ♥　はいって、くるっ♥」	「嗯♥……%ANAME(MASTER)%之源♥嗯，嗯♥」
%ANAME(対象)%は自分の膣内で%ANAME(MASTER)%のペニスを感じているようだ	%ANAME(対象)%似乎在自己的阴道内感受到了%ANAME(MASTER)%的阴茎
「ぁはっ♥、すごい……大きくて、熱い……♥」	「啊哈哈♥好厉害……又大又热……♥」
%ANAME(MASTER)%はペニスを速いテンポで膣内を抽挿しつつ、空いた口で%ANAME(対象)%の乳首に吸いつく	%ANAME(MASTER)%快速地在阴茎内抽插阴茎，用空着的嘴吸着%ANAME(対象)%的乳头
「ふぁっ♥　んっ♥　んっあっ♥　ぁ♥　あはっ♥」	「啊啊啊♥嗯♥嗯，啊♥啊♥啊哈哈♥」
貪るように乳首を吸う%ANAME(MASTER)%に快楽攻めにされ、%ANAME(対象)%はもっと快楽を得ようと%ANAME(MASTER)%の腰に脚を絡めた…	被贪婪地吮吸乳头的%ANAME(MASTER)%攻击了快乐，%ANAME(対象)%为了得到更多快乐而将脚缠在了%ANAME(MASTER)%的腰上…
「ね、動いて……貴方を、もっと感じさせて……♥」	「喂，移动一下……让我更加感受到你……♥」
%ANAME(対象)%の言葉を聞いて%ANAME(MASTER)%は寝そべる%ANAME(対象)%の下半身を持ち上げ、%ANAME(MASTER)%が上から打ち付けるようにストロークする	听了%ANAME(対象)%的话，%ANAME(MASTER)%举起了睡着的%ANAME(対象)%的下半身，%ANAME(MASTER)%从上面打过来
「ぁ♥　はぁんっ♥　カ、カリで、えぐられるぅっ♥」	「啊♥哈酱♥卡，钾，可以挖♥」
「いいのぉ♥　もっと、激しくうごいてぇ♥　ああぁっ♥」	「可以吗♥更加激烈地行动吧♥啊啊啊啊啊♥」
「んぁっ♥　あ、あっ♥　ふぁあっ♥」	「嗯啊啊♥啊，啊♥啊啊啊啊♥」
%ANAME(MASTER)%は小刻みにピストン運動を続ける	%ANAME(MASTER)%一点一点地持续着活塞运动
愛液で満ちた%ANAME(対象)%の肉壷を、覆いかぶさる%ANAME(MASTER)%は熱い肉棒で犯し続ける	用热肉棒将充满爱液的%ANAME(対象)%的肉壶覆盖起来的%ANAME(MASTER)%继续犯下
「%ANAME(MASTER)%の……膣内でどんどん大きくなって、る♥」	「%ANAME(MASTER)%的……在阴道内渐渐变大♥」
「ねぇ♥　そろそろイキそう……？ 私も、もうっ♥」	「喂♥差不多该开始了……？我也要♥」
その言葉を聞いた%ANAME(MASTER)%は一際深く奥へとペニスを突き入れた	听到这句话的%ANAME(MASTER)%更深地刺进了阴茎
「きゃぁんっ♥　いちばん奥に、貴方の……♥」	「啊啊啊♥在最里面，你的……♥」
%ANAME(対象)%はそっと耳元で囁きながら中出しを切望する	%ANAME(対象)%悄悄地在耳边轻声细语着，渴望中出
応えてやろうと%ANAME(MASTER)%は残りの精液を植えつけるべく腰の動きを速めた	%ANAME(MASTER)%为了回应她，加快了腰的动作，准备种剩下的精液
極限まで高まっていくボルテージに身を焦がしながら、二人は果てるまで性器を打ち付けあった…	在将身体燃烧到极限的舞台上，两人一直到最后都被打上了生殖器…
「もう♥　もう……ダメぇぇぇっ♥♥♥♥」	「已经♥已经……不行啊♥♥♥♥」
%ANAME(対象)%に思いっきり腰を打ち付ける%ANAME(MASTER)%	%ANAME(MASTER)%尽情地坐在%ANAME(対象)%的身上
「きゃぅっ♥」	「哦，哦♥」
腰を打ちつけた後、膣内からゆっくりとペニスが抜ける直前まで腰を引く	腰部打结后，从阴道内慢慢地到阴茎脱落之前拉直腰
「はぁ、はぁ……ぁ……♥」	「哈、哈……啊……♥」
%ANAME(対象)%が残念そうな表情をして接合部分を見つめる	%ANAME(対象)%露出遗憾的表情凝视着接合部分
その反応を確かめると、再び思いっきり腰を打ちつけた	确认了那个反应后，再一次痛痛快快地坐下了
「んぁあんっ♥　……もう、じらさ、ないでぇ……」	「嗯，嗯♥　……算了，别卖关子了……」
%ANAME(対象)%は切なそうな表情をしている	%ANAME(対象)%的表情很悲伤
今度は速いストロークで激しく腰を打ち付ける	这次用快球猛击腰
「ふぁあっ♥ ぁ、んぁっ♥　あんっ♥」	「啊啊啊啊♥ 啊，嗯♥嗯♥」
「あっ♥　はげし……ぁ、やぁぁああんっ♥」	「啊♥秃子……啊，呀啊啊啊♥」
「……ふふっ、やっぱりこの体勢、安心できるわ……」	「……呵呵，果然这个姿势，可以放心啊……」
「だって、あなたの姿を真正面から見れるんだもの……」	「因为，能从正面看到你的身影……」
その言葉を聞いて胸がドキリと高鳴る%ANAME(MASTER)%	听到这句话，我的心怦怦地跳动
「んっ♥　ぁ……ふふっ♥　今、おおきくなった♥」	「嗯♥啊……呵呵呵♥现在长大了♥」
%ANAME(MASTER)%は気恥ずかしくなり目を逸らす	%ANAME(MASTER)%因为害羞而移开视线
すると%ANAME(対象)%は両腕を首に絡ませて抱きついてきた	然后%ANAME(対象)%将双臂搂住脖子抱住
「恥ずかしがらないでいいわよ……ね、動いて？」	「别害羞了……喂，动一下？」
%ANAME(MASTER)%は我慢がきかなくなり、腰を激しく動かした	%ANAME(MASTER)%受不了了，腰剧烈地动了起来
「あ♥　ぁ、んぁあっ♥　ふぁ、はぁあんっ♥」	「啊♥啊，嗯啊♥啊，哈哈♥」
「%ANAME(MASTER)%っ♥　 んぁっ♥　大好き……ぁあんっ♥」	「%ANAME(MASTER)%♥嗯啊啊♥最喜欢……啊啊啊♥」
%ANAME(MASTER)%は%ANAME(対象)%を押し倒し、四つん這いの%ANAME(対象)%の秘裂にバックからペニスを突き入れ腰を動かした…	%ANAME(MASTER)%推倒了%ANAME(対象)%，从背后把阴茎刺入了爬在四座的%ANAME(対象)%的秘裂，动了腰…
バックから%ANAME(対象)%の膣内を激しく往復する	从背后激烈地往返于%ANAME(対象)%的阴道内
「ぁあんっ♥　あっ♥　いい、%ANAME(MASTER)%……♥」	「啊啊啊♥啊♥好，%ANAME(MASTER)%……♥」
「膣内で♥　貴方のが♥　暴れて……んぁあっ♥」	「在阴道内♥你的♥暴走……嗯啊啊♥」
%ANAME(対象)%のお尻と尻尾が可愛く揺れている	%ANAME(対象)%的屁股和尾巴摇得很可爱
腰を動かしながら尻尾を優しい手つきで撫でてやる	一边动着腰，一边用温柔的手抚摸尾巴
「んきゃぁっ！？」	「啊啊啊！？」
突然撫でられて驚いたらしい、膣内がペニスをぎゅうぎゅうと締め付けてくる	突然被抚摸了一下，好像吓了一跳，阴道内紧紧地勒紧了阴茎
%ANAME(MASTER)%は射精してしまいそうになったが理性を総動員して押さえ込んだ	%ANAME(MASTER)%快要射精了，但还是动员了理性将其压制住
そして再び腰を激しく前後に動かす	然后再次剧烈地前后移动腰
「んぁっ♥　あぁっ♥　やぁ、イッちゃうぅっ♥♥」	「嗯啊啊♥啊啊啊♥呀，我要♥♥」
後ろから%ANAME(対象)%をいきり勃つ肉棒で犯す%ANAME(MASTER)%は、空いた両腕で%ANAME(対象)%の胸を揉み始める	从背后用勃起的肉棒侵犯%ANAME(対象)%的%ANAME(MASTER)%，用空着的双臂开始揉%ANAME(対象)%的胸
「後ろからだと、一番気持ちいいとこに擦れて……んぁっ♥」	「从后面开始，擦到最舒服的地方……嗯啊啊♥」
余りの気持ちよさに膣内が締め付けられ、余計にカリが膣壁を刺激する	阴道内被过分的舒适性勒紧，更加雁刺激阴道壁
「すごく♥　気持ちいい……んっ♥　はぁっ♥」	「非常♥好舒服……嗯♥哈♥」
「んっ♥　くぅんっ♥　それに……深くまで入ってきて……んぁあっ♥　ひぁっ♥」	「嗯♥嗯，嗯♥而且……深入地进入……嗯啊啊♥啊啊啊♥」
まるで本当に犯しているようで、%ANAME(MASTER)%の肉欲は止まることなく、部屋には性器を打ち付ける音と嬌声が響き続けた…	简直就像真的犯了一样，%ANAME(MASTER)%的肉欲没有停止，房间里不断传来打生殖器的声音和娇声…
愛液に満ちた%ANAME(対象)%の蜜壺を%ANAME(MASTER)%の熱い剛直が蹂躙する	%ANAME(MASTER)%的热血刚直蹂躏着充满爱液的%ANAME(対象)%的蜜罐
責め続けられて腕で上半身を支え切れなくなり、力無くベッドへ倒れ臥す	一直被责备，无法用手臂支撑上半身，无力地躺在床上
「んぅっ♥　……ぁ、はぁんっ♥」	「嗯♥　……啊，哈♥」
「%ANAME(MASTER)%のが ……奥に、当たって……♥」	「%ANAME(MASTER)%的……猜到里面……♥」
奥を貫くたびに%ANAME(対象)%が甘い悲鳴を漏らす	每次贯穿深处%ANAME(対象)%都会发出甜美的悲鸣
その可愛い声をもっと聞きたくなり、%ANAME(MASTER)%は腰の速度を早める	想听到更多可爱的声音，%ANAME(MASTER)%加快了腰的速度
「んぁあっ♥　ちょ、はや……あっ♥　あっ♥　ふぁんっ♥」	「嗯啊啊♥等、哎呀……啊♥啊♥嗯，嗯♥」
快楽に墜ちて思考がまったく回らなくなった%ANAME(対象)%を、%ANAME(MASTER)%はまだ足りぬと膣内を犯し続けた…	陷入快乐思考完全转不过来的%ANAME(対象)%，%ANAME(MASTER)%认为还不够而继续在阴道内犯下…
「ん♥　ぁあっ♥　奥まで、きてるのぉっ……♥」	「嗯♥啊啊啊♥到里面来了啊……♥」
尻だけ上げてベッドに倒れこむ%ANAME(対象)%に%ANAME(MASTER)%は覆いかぶさるようにして腰を動かす	%ANAME(MASTER)%为了让只抬起屁股就倒在床上的%ANAME(対象)%遮住了自己的腰
あとは%ANAME(MASTER)%から与え続けられる快感に身を委ねて嬌声を発し続ける	然后将身体交给%ANAME(MASTER)%带来的快感，继续娇声细语
種付けする為に腰を振り続ける%ANAME(MASTER)%に、%ANAME(対象)%は雌としての幸福感に浸っていた…	%ANAME(対象)%沉浸在为了播种而一直摆动着腰的%ANAME(MASTER)%中，沉浸在作为母的幸福感中…
腰を打ち付けるたびに%ANAME(対象)%の柔らかそうなお尻がぷるぷると波打っている	每一次坐下，%ANAME(対象)%柔软的屁股便扑哧扑哧地拍打着
%ANAME(対象)%のお尻を両手で撫でながら、腰を時計回りにぐるぐると回す	双手抚摸着%ANAME(対象)%的屁股，腰顺时针转动
「んぁあっ♥　膣内、かき回さないでぇっ……♥」	「嗯啊啊♥阴道内请不要搅拌……♥」
再び激しく腰を前後に動かす	腰再剧烈地前后挪动
「ひんっ♥　んぁあっ♥　気持ち、い、ぃやああぁんっ♥」	「一个♥嗯啊啊♥心情，不，不，不♥」
%ANAME(MASTER)%も腰を激しく動かし始める	%ANAME(MASTER)%也开始剧烈地活动腰
「んぅっ♥　はげ、し……やぁんっ♥」	「嗯♥秃子、干……哎呀♥」
%ANAME(対象)%が後ろへ手を伸ばしてきた	%ANAME(対象)%向身后伸出手
%ANAME(MASTER)%は四つん這いになった%ANAME(対象)%の腰を掴み愛液が飛び散る程の速さでピストンする	%ANAME(MASTER)%抓住爬成四级的%ANAME(対象)%的腰，以爱液飞溅般的速度活塞
「んぁあっ♥　%ANAME(MASTER)%っ♥　%ANAME(MASTER)%……っ♥」	「嗯啊啊♥%ANAME(MASTER)%♥%ANAME(MASTER)%……嗯♥」
「んぁ、ぁぁあああ～～～♥♥♥」	「嗯，啊啊啊～～♥♥♥」
受ける%ANAME(対象)%は抑えきれぬボルテージに、上半身を大きくのけ反らして喘ぎ続ける…	受%ANAME(対象)%无法抑制的伏特治，将上半身大幅向后仰继续喘息…
「んぁっあ♥　あっ♥　ふぁあっ♥」	「嗯啊啊♥啊♥啊啊啊啊♥」
「%ANAME(MASTER)%の……膣内でどんどん大きくなって、る……♥」	「%ANAME(MASTER)%的……在阴道内渐渐变大……♥」
「ねぇ、そろそろイキそう……？ 私も、もうっ♥」	「喂，差不多该有活力了……？我也要♥」
「もう♥　もぅ♥　あぁっ♥」	「已经♥已经♥啊啊啊♥」
「んぅっ♥　くっ♥　ぁはぁあんっ♥」	「嗯♥呸♥啊啊啊啊啊♥」
%ANAME(対象)%の片腕を引き寄せて、更に腰を打ち付ける	把%ANAME(対象)%的一只手拉到跟前，再坐下
「んぁあっ！？ この姿勢、奥まで……ぁうっ♥」	「嗯啊！？这个姿势，到里面去……啊啊♥」
「すごぉい♥　届いてる、奥にぃっ……♥♥♥」	「好厉害♥送到了，在里面……♥♥♥」
%ANAME(対象)%は%ANAME(MASTER)%を抱き締めながら腰を降ろして、秘裂で%ANAME(MASTER)%のペニスを飲み込んだ…	%ANAME(対象)%一边抱住%ANAME(MASTER)%一边坐下，以秘密破裂吞噬了%ANAME(MASTER)%的阴茎…
「んっ♥　ぁっ♥　……あっ、はぁんっ♥」	「嗯♥啊啊♥　……啊，哈哈♥」
今度は%ANAME(対象)%の胸に吸い付き、乳首を舌でコロコロと転がす	这次吸到了%ANAME(対象)%的胸部，用舌头咕噜咕噜地滚动乳头
「んはぁっ♥」	「嗯哈哈♥」
気持ち良かったのか、%ANAME(対象)%の体がエビ反りになる	不知是不是心情舒畅，%ANAME(対象)%的身体翻了个筋斗
胸への愛撫を続けながら腰の動きを再開する	一边对胸部持续爱抚，一边重新开始腰部的活动
「は、ぁっ♥　……%ANAME(MASTER)%……っ♥」	「哈，啊♥　……%ANAME(MASTER)%……嗯♥」
「ふふっ♥　ねぇ……これはどう？ 気持ちいい？」	「呵呵呵♥呐……这个怎么样？舒服吗？」
そう言って%ANAME(対象)%は腰をグリグリと回してくる	这样说着，%ANAME(対象)%把腰咕哩咕哩地扭了起来
ペニスに与えられる不規則な快感に%ANAME(MASTER)%は思わず顔をしかめる	%ANAME(MASTER)%不由得皱起眉头，因为阴茎不规则的快感
「ふふ、気持ち良さそうね……んっ♥　あっ……♥」	「呵呵，感觉很舒服呢……嗯♥啊……♥」
腰を動かしている%ANAME(対象)%自身も大分感じてきているようだ	动着腰的%ANAME(対象)%自己也感觉到了很多
%ANAME(MASTER)%は腰を前に突き出す	%ANAME(MASTER)%向前伸腰
「んぅっ♥　ぁはぁっ♥　ん、やぁあっ……♥」	「嗯♥啊啊啊啊啊♥嗯，哎呀……♥」
「ふむ………、んちゅっ………♥」	「嗯………嗯，嗯………♥」
二人はベッドの上で濃厚なキスを繰り返し、抱き合いながら互いを求めあう身体を重ねる	两人在床上重复着浓烈的接吻，抱在一起互相寻求对方的身体重叠在一起
「んぅっ♥　ぁ、はぁっ♥」	「嗯♥啊，哈♥」
舌でお互いの口内を犯しながら、性器でも体液を分泌して飽きずに抽挿をし続ける	一边用舌头在口腔内犯下错误，一边用生殖器分泌体液，不腻烦地持续抽插
%ANAME(対象)%は%ANAME(MASTER)%から与えられ続ける快感に悶えている	%ANAME(対象)%为%ANAME(MASTER)%持续给予的快感而烦恼
「んっ♥　くっ、はぁっ……♥」	「嗯♥呜、哈……♥」
%ANAME(MASTER)%は%ANAME(対象)%を抱きしめて腰の動きを早めた	%ANAME(MASTER)%抱着%ANAME(対象)%加快了腰的动作
「%ANAME(MASTER)%っ♥　私、きちゃうぅっ……♥」	「%ANAME(MASTER)%♥我会的……♥」
動きは徐々に激しくなり、淫らな腰つきで二人は動いていった…	动作渐渐激烈起来，两人以淫荡的姿势移动着…
「ふぁ♥　ぁああんっ♥」	「呵♥啊啊啊啊♥」
「んっ♥　……くっ、はぁっ♥」	「嗯♥　……呜、哈♥」
%ANAME(MASTER)%のペニスの長さに合わせて腰を振る幅を調整し、テンポよく膣壁で勃起する男根を貪る	配合%ANAME(MASTER)%阴茎的长度调整摆动腰的幅度，有节奏地贪图在阴道壁勃起的男根
「もっと、きて……♥　もっと、激しくっ……♥」	「再来一点……♥更加激烈……♥」
%ANAME(対象)%は脚を絡めてきて更なる激しさを求める	%ANAME(対象)%缠住脚寻求更激烈的力量
膣内がキュッと締まって%ANAME(MASTER)%のペニスを圧迫する	阴道内紧闭压迫%ANAME(MASTER)%阴茎
負けじと腰の速度を上げる%ANAME(MASTER)%	不服输提高腰的速度的%ANAME(MASTER)%
パンパンと淫らな音が響くなか%ANAME(対象)%は得られる快感に身を捩りながら、軽いキスをして献身的に腰を弾ませていった…	在淫乱的声音中，%ANAME(対象)%得到了快感，身体一边扭动着，一边轻吻着她，忘我地弹着腰…
「ぁ、あっ♥　%ANAME(MASTER)%っ♥　んんっ♥」	「啊，啊♥%ANAME(MASTER)%♥嗯，嗯♥」
ゆっくりと%ANAME(対象)%の膣内にペニスを出し入れをする	慢慢地在%ANAME(対象)%的阴道内拿出阴茎
しかし、それだと物足りないのか、%ANAME(対象)%は自分から腰を振ってくる	但是，这样的话总觉得有点欠缺，%ANAME(対象)%自己开始摇起腰来
「ふふっ……遠慮しないでいいのですよ？ もっと……♥」	「呵呵……不用客气？更多……♥」
お互い手足で強く抱きしめ合い、快楽に滾る身体を弾ませていく	两人用手脚紧紧地拥抱在一起，让快乐的身体沸腾起来
「激しく……動いて？ ……んむっ♥」	「激烈地……移动……嗯，嗯♥」
上下に動く度に膣壁に当たるカリの快感に、お互い身体を小さく痙攣させる	每次上下移动都能感受到贴在阴道壁上的钾的快感，让身体小小地痉挛
接合部から響く卑猥な水音に興奮しつつ、%ANAME(MASTER)%は射精が近い肉棒で子宮口を叩き始めた…	在兴奋于从接合处传来的猥亵水声的同时，%ANAME(MASTER)%开始用射精附近的肉棒敲打子宫口…
「んぁあっ♥　そう、もっとっ♥　動いてぇっ♥　はぁあんっ♥」	「嗯啊啊♥是的，更加♥移动吧♥哈哈♥」
%ANAME(MASTER)%は%ANAME(対象)%の身体を背後から抱き上げると、秘裂を貫いて愛撫しながら腰を突き上げた…	%ANAME(MASTER)%从背后抱住了%ANAME(対象)%的身体，一边抚摸着秘裂的身体一边抬起了腰…
「んぁあぅっ♥　ぁ、ふぁあんっ♥」	「嗯啊啊啊♥啊，啊啊♥」
%ANAME(対象)%の膣内がキュッと締まり、ペニスの挿入を拒もうとする	%ANAME(対象)%的阴道内紧紧地勒紧，拒绝阴茎的插入
背面座位で激しいストロークしながら、%ANAME(対象)%は首をこちらに向かせてキスをおねだりする	在后座上激烈的击球，%ANAME(対象)%的头朝这边来要求接吻
しかし結局は逆効果となり、%ANAME(MASTER)%のペニスは更に硬さを増す	但结果却适得其反，%ANAME(MASTER)%的阴茎更加坚硬
「！？ ちょっ……まだ、大きく……！？」	「！？ 等一下……还很大……！？」
興奮が高まる度にグラインドも淫らになっていき、ピッチも短くなっていく	随着兴奋度的高涨，滑翔伞也变得淫荡起来，间距也变短了
「や、はぁんっ♥　すごっ♥　こんなのっ♥　おかしく…なっ、ちゃう♥♥」	「呀，哈哈♥太厉害了♥这样啊♥奇怪…变、变♥♥」
迫る絶頂に達するべく、二人は発情した獣のようにピストンを激しくしていった…	为了达到逼近的绝顶，两人像发情的野兽一样激烈地进行着活塞运动…
「んっ♥　ぁあっ♥　気持ち、いいっ……♥」	「嗯♥啊啊啊♥心情很好……♥」
「ぁっ♥　んぁっ♥　……ねぇ、ここも……ね♥」	「啊啊♥嗯啊啊♥　……喂，这里也是……对吧♥」
動くのを%ANAME(対象)%に任せ、%ANAME(MASTER)%は隆起する%ANAME(対象)%の乳首を指でつまんだ	%ANAME(MASTER)%把行动交给了%ANAME(対象)%，用手指捏住了隆起的%ANAME(対象)%的乳头
「んっ♥　ぁ、はぁんっ……♥」	「嗯♥啊，哈……♥」
ビクンと身体を跳ねさせる%ANAME(対象)%をさらに刺激してやる為に乳頭を軽く引っ張った	为了进一步刺激扑腾身体的%ANAME(対象)%，把乳头轻轻拉了一下
「きゃっ♥　い、いきなりはげしくっ　しないでっ……♥」	「客人♥喂，不要一下子就秃顶了……♥」
余裕が無くなった%ANAME(対象)%の動きは激しく大胆なものになっていき、その刺激で%ANAME(MASTER)%も射精感を高めていった…	没有了富余的%ANAME(対象)%的动作变得非常大胆，因为这个刺激%ANAME(MASTER)%也提高了射精感…
「っくぅ♥　はぁぁああんっ♥」	「嗯，嗯♥哈哈啊啊♥」
%ANAME(対象)%の体重を感じながら腰を動かす	一边感受着%ANAME(対象)%的体重一边活动腰
「んぁっ♥　はぁっ♥　……ねぇ、今度は私が動くから…♥」	「嗯啊啊♥哈♥　……喂，这次我要动了…♥」
そう言うと%ANAME(対象)%は腰を上下に動かし始めた	这样说着，%ANAME(対象)%开始上下移动腰
「あぁっ♥　貴方のがっ♥　膣内でっ……♥」	「啊啊啊♥你管索引♥阴道内……♥」
「%ANAME(MASTER)%っ♥　んぁっ♥　%ANAME(MASTER)%っ……♥」	「%ANAME(MASTER)%♥嗯啊啊♥%ANAME(MASTER)%……♥」
「んっ♥　はげし♥　ぁあっ♥」	「嗯♥秃子♥啊啊啊♥」
性器を打ち付け合うごとに撒き散らされる愛液に欲情しつつ、%ANAME(MASTER)%はピストンを速めた	每打一次生殖器，就会对散落的爱液产生欲望，而%ANAME(MASTER)%则加速了活塞运动
「すご、ぉいっ♥♥♥　……奥に、当たってる……♥」	「好厉害，好厉害♥♥♥　……猜到里面了……♥」
%ANAME(MASTER)%の首に腕を回してくる%ANAME(対象)%	在%ANAME(MASTER)%的脖子上转动手臂的%ANAME(対象)%
「ぁっ♥　あっ♥……ひぅぅううんっ♥」	「啊啊♥啊♥……嗯，嗯♥」
艶めかしい声で喘ぐ%ANAME(対象)%は、貪るように自らも腰を淫らに動かしていく…	因娇艳的声音而喘息的%ANAME(対象)%，像贪图一样自己也淫荡地活动着腰…
%ANAME(対象)%の後ろから胸を揉む%ANAME(MASTER)%	从%ANAME(対象)%背后揉胸的%ANAME(MASTER)%
「やっ♥　おっぱい……揉まないで、感じちゃうからぁ……♥」	「哎呀♥乳房……不要揉，因为感觉到了……♥」
%ANAME(対象)%の胸の感触を楽しみながら腰を小刻みに振り続ける	一边享受着%ANAME(対象)%心中的触感，一边小心谨慎地摆动着腰
「や♥　だめぇ♥♥　膣内と♥　おっぱい同時に♥　なんてぇっ……♥♥♥」	「蚊帐♥不行啊♥♥阴道内和♥同时乳房♥什么啊……♥♥♥」
「あっ♥　ぁ……♥」	「啊♥啊……♥」
「んっ…♥！中に出てる…これは”出来る”かもしれないですね…♥？」	「嗯…♥！里面有…这可能是"可以"吧…♥？」
トロトロの肉壷に捉えられたペニスを激しいグラインドで腰を振る	用激烈的滑翔机摇晃着被抓住在托罗肉壶里的阴茎
「………朝…？」	「………早上…？」
「…………ちゅっ♥」	「…………啾♥」
「………おはよう%ANAME(MASTER)%♥」	「………早上好♥」
「…………ふふっ♥」	「…………呵呵呵♥」
お互いまどろみから目覚め切ると、いつもの仕事の準備をするために二人は服を着始める	两个人从互相的窗户中醒来，为了准备平时的工作，两个人开始穿衣服
支度を終えた%ANAME(対象)%は不意に%ANAME(MASTER)%に軽く口付けすると、笑顔で一足先に退出していった…	准备结束后的%ANAME(対象)%突然轻轻地吻了%ANAME(MASTER)%，笑着先走了一步…
ふと唇に柔らかい感触がしたので、眠っていた%ANAME(MASTER)%は瞼を開く	突然嘴唇有了柔软的触感，睡着的%ANAME(MASTER)%睁开了眼睑
ぼやけ気味の視界には、今まさに唇を重ねている%ANAME(対象)%の顔が映った	在朦胧的视野中，现在正是双唇重叠的%ANAME(対象)%的脸
%ANAME(MASTER)%が目を覚ましたのに気付くと、%ANAME(対象)%は恥ずかしげに微笑んだ…	当注意到%ANAME(MASTER)%醒了的时候，%ANAME(対象)%害羞地微笑了…
唾液を交換するほどの濃厚なキスを終え、%ANAME(対象)%の顔を見るとどうやらスイッチが入ってしまったようだ	结束了激烈的交换唾液的吻后，看到了%ANAME(対象)%的脸，好像被开关打开了
仕事の準備もあるので発情した%ANAME(対象)%を我慢させた後、腕に抱きつく%ANAME(対象)%と共に部屋を出た…	因为有工作的准备，所以让发情的%ANAME(対象)%忍耐住后，和抱在手臂上的%ANAME(対象)%一起离开了房间…
お目覚めのキスで目覚めた%ANAME(対象)%は鼻歌交じりに着替えを終え、%ANAME(MASTER)%の腕に甘えるように抱きつく	从唤醒的吻中醒来的%ANAME(対象)%哼着小曲换完衣服，像在%ANAME(MASTER)%的手臂上撒娇般地抱住他
その後、気分の乗った二人はギリギリの時間までイチャイチャし続けた…	在那之后，心情愉快的两个人一直在调情到最后一刻…
