「っ！！　…………ほ、本気か？　%ANAME(MASTER)%……」	「！！…………这是...真的吗？%ANAME(MASTER)%……」
こんな事、遊びでは口にしない。本気だと伝えると、%ANAME(TARGET)%は感極まった様子で%ANAME(MASTER)%を抱きしめた	这种事情，是不能开玩笑的呢，于是告诉她是认真的，%ANAME(TARGET)%感慨万千地抱住了%ANAME(MASTER)%露出了笑容
「…嬉しいぞ、%ANAME(MASTER)%…お前からその言葉を聞けて…っ」	「…真开心呢、%ANAME(MASTER)%…从你那收到了告白…」
%ANAME(MASTER)%を強く抱きしめる%ANAME(TARGET)%の目には、うっすらと涙が浮かんでいた	%ANAME(MASTER)%紧紧地抱住了眼眸通红、潸然泪下的%ANAME(TARGET)%
「%ANAME(MASTER)%…、私もお前のことが、好きだ。…これからも私と一緒にいておくれ…♥」	「%ANAME(MASTER)%、我也喜欢你。今后也请和我在一起吧…♥	」
%ANAME(TARGET)%は満面の笑みを見せ、%ANAME(MASTER)%の唇を激しく奪った…	%ANAME(TARGET)%满面笑容，激动地夺走了%ANAME(MASTER)%的嘴唇…
少しの静寂の後、%ANAME(TARGET)%は口を開く。その頬はやや赤くなっていた	少时的寂静后、%ANAME(TARGET)%开了口。那双脸颊染上了绯红
「その気持ち、受け止めよう。…私もその…お前のことは、嫌いじゃ…ないぞ…」	「这份心情...我接受了。…我也是…那个...对你、讨厌什么的…并没有啊…」
%ANAME(TARGET)%はそう言うと、%ANAME(MASTER)%を優しく抱きしめる	%ANAME(TARGET)%这样说着，温柔地抱住了%ANAME(MASTER)%
%ANAME(MASTER)%もまた%ANAME(TARGET)%の抱擁に応えて腕を背に回して抱き合い、やがて熱い口付けをかわした…	%ANAME(MASTER)%也回应了%ANAME(TARGET)%的拥抱，两人相拥而吻…
「……すまない。気持ちは嬉しいが、今はまだそういう気持ちになれないんだ」	「……对不起，然很高兴，但是现在还没有那种心情谈恋爱」
%ANAME(TARGET)%はしばし悩んだ後、そう言った	%ANAME(TARGET)%烦恼了一会后，这样说道
「…もう少し%ANAME(MASTER)%のことを見極めさせてくれ。そうしたら、答えも変わってくるかもしれない…」	「…再让我多了解%ANAME(MASTER)%一段时间。那样的话，答案会改变也不一定…」
「あ、こ、こら…だめだってぇ……」	「啊，这个，这样子…不行啊……」
%ANAME(TARGET)%は酔いが回って%ANAME(MASTER)%を拒みきれないようだ	%ANAME(TARGET)%醉得迷糊似乎无法拒绝%ANAME(MASTER)%的请求
「あっ……私を、抱きたいのか？」	「啊……你想抱我吗？」
「…ふふっ、しょうがないやつだな%ANAME(MASTER)%は」	「…fufu、真是没办法的家伙啊，%ANAME(MASTER)%桑」
%ANAME(TARGET)%は抵抗することなく、むしろ進んで%ANAME(MASTER)%に身体を委ねている	%ANAME(TARGET)%没有抵抗，反而主动地把身体交给了%ANAME(MASTER)%
「…本当はな、%ANAME(MASTER)%が抱いてくれるのを待っていたんだぞ…♥」	「…说实话…我一直等着%ANAME(MASTER)%来抱我呢…♥」
%ANAME(TARGET)%は頬を染めて微笑みながら、%ANAME(MASTER)%の服にも手をかける	%ANAME(TARGET)%双颊带着殷红、笑着将手放在了%ANAME(MASTER)%的衣服上
「さあ、私だけ裸なんて無い話だ。%ANAME(MASTER)%の裸も見せてくれ♥」	「那么，只有我一个裸体是不公平的。让我也可看看%ANAME(MASTER)%的裸体吧♥」
「あっ……ふう、そんなに私を抱きたのか？　まったく仕方ないな…」	「啊……豁、那么想抱我吗？真是没办法啊…」
%ANAME(TARGET)%は%ANAME(MASTER)%の目の前で服を脱いでゆく	%ANAME(TARGET)%在%ANAME(MASTER)%的面前将衣服脱了下来
「どうせするならちゃんと気持ちよくしてくれよ？」	「既然要做的话，那么就好好地舒服起来吧？」
「駄目だ」	「不行」
%ANAME(MASTER)%は%ANAME(TARGET)%に腕をひねられ、投げ倒された	%ANAME(MASTER)%的手臂被%ANAME(TARGET)%扭倒
「……気持ちは察するが、もうちょっと自制しろ」	「……我能理解你的心情，但还是再克制一下吧」
「あ…もう待ちきれないか？　ふふ、待たせてしまってごめんな」	「啊…已经等不及了吗？fufu，让你久等了，对不起」
「さあ、旦那様…私の身体でいっぱい気持ちよくしてあげるからな♥」	「那么，夫君…我会用我的身体让你舒服起来的♥」
腰をくねらせながら、%ANAME(TARGET)%は妖艶に笑う	%ANAME(TARGET)%一边扭着腰、一边媚笑着
%ANAME(TARGET)%は%ANAME(MASTER)%に身体を摺り寄せながら服を脱いでいる、	%ANAME(TARGET)%一边将身体贴近%ANAME(MASTER)%一边脱下衣服
「もう%ANAME(MASTER)%に触れていないと落ち着かない身体になってしまったよ…」	「已经变成了不接触%ANAME(MASTER)%就无法安心的身体了…」
「ああ、愛しい旦那様…。今日も%ANAME(TARGET)%を、幸せにしてくださいな…♥」	「啊啊，心爱的夫君大人…。今天也请让%ANAME(TARGET)%幸福起来吧…♥」
「あっ♥……もう、そんなに私を抱きたいのか？　しょうがない旦那様だ♥」	「啊♥……已经、这么想抱我了嘛？真是没办法的夫君大人啊♥」
%ANAME(TARGET)%はそう言うと服を脱ぎ、蕩けた表情で%ANAME(MASTER)%に抱きついた	%ANAME(TARGET)%这样说着一脸妩媚脱下衣服抱住了%ANAME(MASTER)%
「まぁ、そう言いつつ私も%ANAME(MASTER)%に抱かれたくてたまらないんだがな♥」	「嘛、虽然是这么说，但我也很想被%ANAME(MASTER)%所抱呢♥」
「さあ、%ANAME(MASTER)%…今夜は燃え上がろうか♥」	「那么、%ANAME(MASTER)%…享受今宵的欢腾吧♥」
「あっ…もう我慢できないか？　ふふっ、私もだよ%ANAME(MASTER)%♥」	「啊…已经忍耐不住了吗？fufu~，我也是哦%ANAME(MASTER)%♥」
%ANAME(TARGET)%は自ら服をはだけて、%ANAME(MASTER)%の身体に自慢の尻尾を絡めてきた	%ANAME(TARGET)%一边脱着衣服一边用引以为傲的尾巴缠绕着%ANAME(MASTER)%的身体
「愛しい旦那様…今日も%ANAME(TARGET)%が、いっぱい気持ちよくしてあげる♥」	「亲爱的夫君大人…今天由%ANAME(TARGET)%来、让你感受快乐吧♥」
「今回は私が脱がしてあげよう。さ、力を抜いてバンザイして…」	「这次由我来帮你脱掉吧。那么，就来放松一下吧…」
%ANAME(TARGET)%は%ANAME(MASTER)%の服を手を掛ける。脱がしに掛かる手つきが艶かしい	%ANAME(TARGET)%将手放在%ANAME(MASTER)%的领口，用妖艳的手法脱着衣服
「ふふ、もうビンビンだ……コレで今から私を愛してくれるんだな♥」	「fufu、已经硬邦邦的呢……今天就用这个好好爱我吧♥」
%ANAME(TARGET)%は蕩けた表情で%ANAME(MASTER)%の肉棒を手に取り撫でている…	%ANAME(TARGET)%一脸妩媚地拿着%ANAME(MASTER)%的肉棒，温柔地套弄着...
「はぁ…愛しい旦那様のコレ…触ってるだけでも幸せだよ♥」	「哈啊…夫君大人的那个…光是触碰着就觉得幸福了呢♥」
「あん♥…ふふ、そんなに焦らなくとも私は%ANAME(MASTER)%だけのものだよ…♥」	「啊♥…fufu、不要这么心急，我是属于%ANAME(MASTER)%的呢…♥」
%ANAME(TARGET)%が服を脱ぐたび、彼女の美しい肢体が露わになり%ANAME(MASTER)%の目を釘付けにする	每当%ANAME(TARGET)%脱下衣服，她那美艳的身子就会露出来，%ANAME(MASTER)%目不转睛地盯着那充满魅力的胴体
「さぁ、旦那様…今夜も私を愛して♥」	「那么、夫君大人…今晚...也好好爱我吧♥」
「あ…もう待ちきれないか？」	「啊…已经等不及了吗？」
「ふふ、待たせてしまってすまない。私の身体でいっぱい気持ちよくしてあげるからな♥」	「fufu、让你久等了。我会用我的身体让你感受快乐的~♥」
「もう%ANAME(MASTER)%に触れていないと落ち着かない身体になってしまったんだ」	「不触及%ANAME(MASTER)%的话身体就无法平静了呢」
「%ANAME(MASTER)%…。今日も私を、幸せにしておくれ…♥」	「%ANAME(MASTER)%…。今天也...好好宠幸我吧…♥」
%ANAME(TARGET)%は服を脱ぐと、蕩けた表情で%ANAME(MASTER)%に抱きついた	%ANAME(TARGET)%脱下了衣服、一脸妩媚地抱着%ANAME(MASTER)%
「%ANAME(MASTER)%に抱かれると、幸せを感じるんだ♥」	「被%ANAME(MASTER)%抱的话，会觉得幸福呢♥」
「あっ…もう我慢できないか？　ふふっ、私もなんだ♥」	「啊…已经忍耐不住了吗？fufu，我也是呢♥」
「愛しい%ANAME(MASTER)%…今日もいっぱい、気持ちよくしてあげるからな♥」	「亲爱的%ANAME(MASTER)%桑…今天也要好好地...舒服起来哦♥」
「ふふ、もうビンビンだ……これで今から私を愛してくれるんだな♥」	「fufu、已经硬邦邦的呢……今天就用这个好好爱我吧♥」
%ANAME(TARGET)%は蕩けた表情で%ANAME(MASTER)%の肉棒に頬ずりしている…	%ANAME(TARGET)%一脸妩媚地亲着%ANAME(MASTER)%的肉棒...
「あん…ふふ、そんなに焦らなくとも私は%ANAME(MASTER)%のモノだよ…♥」	「啊♥…fufu、不要这么心急，我可是属于%ANAME(MASTER)%的…♥」
「さぁ、%ANAME(MASTER)%…私を愛して♥」	「那么、%ANAME(MASTER)%…爱我吧~♥」
「ん…もう待ちきれないか？」	「嗯…已经等不及了吗？」
「ふふ、いいぞ…私の身体、存分に味わってくれ♥」	「fufu、好吧…我的身子、尽情地享用吧♥」
%ANAME(TARGET)%は服を脱ぐと、%ANAME(MASTER)%に抱きつく	%ANAME(TARGET)%脱下了衣服、抱住了%ANAME(MASTER)%
「%ANAME(MASTER)%に抱かれると、安心できて好きなんだ…」	「被%ANAME(MASTER)%抱的话，会变得安心了呢…」
「今日も私を愛しておくれ…」	「今天也请爱我吧…」
%ANAME(TARGET)%は服を脱ぐと、笑顔で%ANAME(MASTER)%に抱きついた	%ANAME(TARGET)%脱下衣服，笑着抱住了%ANAME(MASTER)%
「今日も私を気持ちよくしておくれ」	「今天也让我好好舒服起来哦」
「あっ…もう我慢できないか？　ふふっ、私もだ♥」	「啊…已经忍耐不了了吗？fufu、我也是哦♥」
「今日もいっぱい、気持ちよくしてあげるからな♥」	「今天也会让你好好舒服起来的♥」
「今回は私が脱がしてやろう。さ、力を抜いてバンザイして…」	「这次由我来帮你脱掉吧。那么，就放松一下吧…」
「ふふ、ここはもうはちきれそうだな……今楽にしてあげるからな…♥」	「fufu、这里已经肿得难受了吧…马上就让你轻松起来哦…♥」
%ANAME(TARGET)%は期待に満ちた眼で%ANAME(MASTER)%の下着を脱がしていく…	%ANAME(TARGET)%用充满期待的眼眸脱掉了%ANAME(MASTER)%的内衣…
「あん…ふふ、そんなに焦らなくとも大丈夫だよ…♥」	「啊…呵呵，不用那么着急也没关系的…♥」
「ふふ…さぁ、抱いておくれ♥」	「fufu…来、抱我吧♥」
「あっ……もう、そんなに私を抱きたいのか？　まったく仕方ないやつだ…」	「啊……你已经那么想抱我了吗？真是个没办法的家伙…」
「%ANAME(MASTER)%。ちょっと…」	「%ANAME(MASTER)%。稍微过来下…」
デート中、%ANAME(MASTER)%は%ANAME(TARGET)%に呼び止められた	约会中，%ANAME(MASTER)%被%ANAME(TARGET)%叫住了
何かと思って振り向くと、不意打ちのように%ANAME(TARGET)%に口付けされた	想着是有什么事的时候、突然被%ANAME(TARGET)%吻了
いきなりの大胆行動に、すこし慌ててしまう	对于这突然的大胆行动，吃了一惊
「…ふふ、けっこう可愛い反応するんだな。また一つ、%ANAME(MASTER)%のことが分かったよ」	「…fufu，真是可爱的反应呢。又发现了一个%ANAME(MASTER)%有趣的地方呢」
「なあ、%ANAME(MASTER)%。少し話があるんだ…聞いてくれないか？」	「啊，%ANAME(MASTER)%。有点事想说…可以打扰下吗？」
デートの帰り、%ANAME(MASTER)%は%ANAME(TARGET)%に呼び止められた	约会结束后，%ANAME(MASTER)%被%ANAME(TARGET)%叫住了
%ANAME(TARGET)%の頬はやや赤くなっていたが、とても真剣な眼差しで%ANAME(MASTER)%に話しかける	%ANAME(TARGET)%的脸颊微红，但是用非常认真的眼神对%ANAME(MASTER)%说道
「そ、その、なんだ、……近頃、%ANAME(MASTER)%と一緒にいるとな？」	「那个、那什么……最近...和%ANAME(MASTER)%在一起」
「すごく胸がドキドキするというか、もやもやするというか…、でも嫌な気分じゃなくて」	「真的是心跳不已呢，还是朦胧的感觉呢…但是并不是那种讨厌的心情」
「会ってない時にも、お前のことを考えてて、ずっと頭から離れないんだ…」	「即使没有见面，也会想着你，一直在脑海里挥之不去…」
「…多分私は、%ANAME(MASTER)%に…恋を、している……のだと思う…」	「…大概是、对%ANAME(MASTER)%桑…恋爱了吧……我想是这样的…」
「…私はお前のことが…好き…だ…」	「…我对你…那个...喜…喜欢哦…」
「……お前の気持ちを、聞かせて欲しい……」	「……我想听听...你的感受呢……」
%ANAME(TARGET)%は顔を真っ赤にして俯き、返事を待っている。%ANAME(MASTER)%は…	%ANAME(TARGET)%满脸通红、低着头等待着回复。%ANAME(MASTER)%是…
「…嬉しいよ…%ANAME(MASTER)%からその言葉を聞けて…っ！」	「…好开心…从%ANAME(MASTER)%那听到这句话…嘻嘻！」
そう言うと%ANAME(TARGET)%は%ANAME(MASTER)%を強く抱きしめた。その目にはうっすらと涙が浮かんでいた	这样说着，%ANAME(TARGET)%紧紧地抱住了%ANAME(MASTER)%，梨花带雨地笑着
「っ勇気を出して良かった……！　%ANAME(MASTER)%、これからも私と一緒にいておくれ…♥」	「能拿出勇气真是太好了……！　%ANAME(MASTER)%、今后也请和我在一起…♥」
「…！！　……そ、そうか…」	「…！！　……是、是吗…」
%ANAME(TARGET)%は顔を上げて%ANAME(MASTER)%の返事を聞くと、再び俯いた	%ANAME(TARGET)%抬起头听了%ANAME(MASTER)%的回复后，又垂下了头
「…すまない…変なことを聞いてしまって……っ…っ」	「…对不起…让你听到奇怪的事了……嗯…呜」
水滴が地面を濡らす。俯いた顔から涙が零れていた	地面上湿润了。是她低着头脸上垂下的眼泪
「…このことは忘れてくれ…すまなかった…」	「…请忘记这件事吧…对不起…」
%ANAME(TARGET)%は最後まで顔を上げることが出来なかった…	%ANAME(TARGET)%直到最后都没能抬起头来…
%ANAME(TARGET)%は%ANAME(MASTER)%をいきなり押し倒してきた。	%ANAME(TARGET)%突然把%ANAME(MASTER)%推倒了。
「…何だか%ANAME(MASTER)%といると、やらしい思いがこみ上げてくるんだ…」	「…总觉得和%ANAME(MASTER)%在一起的话，会有中不妙的冲动涌上来…」
%ANAME(TARGET)%は押し倒した%ANAME(MASTER)%の腰に跨り、服を脱ぎ始めた	%ANAME(TARGET)%跨在推倒的%ANAME(MASTER)%的腰上，开始脱着衣服
「…なぁ、%ANAME(MASTER)%…私とシよう♥」	「…啊，%ANAME(MASTER)%…和我一起♥」
%ANAME(TARGET)%はそう言いながら%ANAME(MASTER)%の服を脱がし始めた…	%ANAME(TARGET)%一边这样说着一边开始脱下%ANAME(MASTER)%的衣服…
赤ら顔の%ANAME(TARGET)%は%ANAME(MASTER)%をいきなり押し倒してきた。	红着脸的%ANAME(TARGET)%突然推倒了%ANAME(MASTER)%。
「…何だか今日は、いやらしい気持ちが湧き上がって来るんだ…」	「…总觉得今天有种不妙的冲动涌了上来…」
「…すまない、%ANAME(MASTER)%。もう我慢できない…」	「…抱歉，%ANAME(MASTER)%。我已经忍不住了…」
%ANAME(TARGET)%は%ANAME(MASTER)%を優しく押し倒した！	%ANAME(TARGET)%温柔地推倒了%ANAME(MASTER)%！
「はしたない妻でごめんな…でも、もう%ANAME(MASTER)%のが欲しくて堪らないんだ！」	「对不起，我是这样粗野的妻子…但是，我已经非常想要%ANAME(MASTER)%的了！」
%ANAME(TARGET)%は%ANAME(MASTER)%の服を脱がせながら丁寧に全身を愛撫していく。	%ANAME(TARGET)%一边脱下%ANAME(MASTER)%的衣服一边细心地爱抚着全身。
「力を抜いて…大丈夫。いっぱいキモチよくしてあげるから……」	「请放松…没关系的。我会让你舒服起来的……」
「さあ……旦那様の愛を、私にいっぱい注いでおくれ♥」	「那么，请把夫君大人的爱...倾注到我身上吧♥」
%ANAME(TARGET)%は%ANAME(MASTER)%を押し倒して腰に跨ってきた	%ANAME(TARGET)%推倒%ANAME(MASTER)%跨坐在腰上
「%ANAME(MASTER)%？　これでお仕舞いなんて、ないじゃないか…♥」	「%ANAME(MASTER)%？ 这样的话，就没办法逃走了吧…♥」
%ANAME(TARGET)%は服を脱ぎ、露わになった乳房を%ANAME(MASTER)%に見せ付ける	%ANAME(TARGET)%将衣服敞开、露出了乳房给%ANAME(MASTER)%看
「ねぇ見て…私の乳首、もうビンビン……♥」	「呐…看我的乳头、已经硬起来了呢……♥」
「愛しい旦那様に、吸ってもらいたくて…堪らないからだよ」	「想和亲爱的夫君大人结合…想地受不了了呢」
「だから、ね……シよう♥」	「所以呢...呐……做吧♥」
これからの行為を期待して、%ANAME(TARGET)%の表情はさらに淫らに蕩ける……	期待着接下来的行为、%ANAME(TARGET)%的神情愈发妖媚着……
%ANAME(TARGET)%は%ANAME(MASTER)%を押し倒して顔と顔を付き合わせる	%ANAME(TARGET)%把%ANAME(MASTER)%推倒把脸贴了上去
「ふふ♥　旦那様、どこへ行くんだい？　夫婦の夜はまだこれからだぞ♥」	「fufu♥　夫君大人、你想去哪呢？　夫妻之夜还长着呢♥」
%ANAME(TARGET)%は自らの乳房をぐいぐい押し当てて%ANAME(MASTER)%を誘惑している	%ANAME(TARGET)%使劲按着自己的乳房诱惑着%ANAME(MASTER)%
「%ANAME(MASTER)%といると、身体が幸せを求めて疼いて来るんだ…♥」	「和%ANAME(MASTER)%在一起呢、身体就为了索求幸福而呻吟着呢…♥」
%ANAME(TARGET)%は艶かしく服を脱ぎ、%ANAME(MASTER)%の股間を撫で上げる	%ANAME(TARGET)%艳丽地脱掉衣服，抚摸着%ANAME(MASTER)%的胯间
「だから%ANAME(MASTER)%のコレで、私をもっと幸せにしてぇ♥」	「所以啊...用%ANAME(MASTER)%的这个、让我幸福起来吧~♥」
「…%ANAME(MASTER)%といると、身体がすごく疼いて…とてもいやらしい気分になる…♥」	「…和%ANAME(MASTER)%在一起的话、身体会觉得苦闷…感觉很焦躁…♥」
%ANAME(TARGET)%は%ANAME(MASTER)%に、豊満な胸を押し当てるように押し倒す	%ANAME(TARGET)%把丰满的胸部压在%ANAME(MASTER)%身上
「ほら見て…私のここ、%ANAME(MASTER)%のが欲しくて泣いてる……」	「看吧…我的这里、想要%ANAME(MASTER)%的咕噜咕噜地淌着……」
%ANAME(TARGET)%は%ANAME(MASTER)%に自らの蜜を滴らせる秘所を見せ付け性交をねだっている	%ANAME(TARGET)%向%ANAME(MASTER)%展示着那蜜汁横流的期待着性交的秘处
「このいやらしい妻のココを、旦那様ので慰めておくれ…♥」	「我这不像样的妻子、夫君大人好好抚慰我吧…♥」
「なぁ、%ANAME(MASTER)%」	「呐，%ANAME(MASTER)%」
%ANAME(MASTER)%は%ANAME(TARGET)%の呼びかけに振り向くと、グイっと引っ張りこまれた	%ANAME(MASTER)%被%ANAME(TARGET)%的呼声所唤而转过头时、被拉了过去
強く引っ張られたため、あたかも%ANAME(MASTER)%が%ANAME(TARGET)%を押し倒したような体勢になった	因为强力地拉扯，二人的姿势就像%ANAME(MASTER)%推到了%ANAME(TARGET)%一样
「…エッチ、しよう♥」	「…呐、做吧♥」
%ANAME(TARGET)%は%ANAME(MASTER)%の首元に手を回し、頭を豊満な胸で抱き包みながら色っぽく囁く	%ANAME(TARGET)%的手环抱过%ANAME(MASTER)%脖子、将丰满的胸部裹住了头妖媚地私语道
「今日は夫婦で…果てるまでシよう♥」	「今天的夫妇时刻…进行到最后吧♥」
「…すまない、%ANAME(MASTER)%。もう我慢できない」	「…对不起、%ANAME(MASTER)%。我已经忍不住了…」
%ANAME(TARGET)%は%ANAME(MASTER)%を押し倒した！	%ANAME(TARGET)%推倒了%ANAME(MASTER)%！
「はしたなくてごめんな…でも、%ANAME(MASTER)%のが欲しくて堪らないんだ」	「不好意思我太粗鲁了…但是，已经非常想要%ANAME(MASTER)%了」
「さあ、力を抜いて…大丈夫。キモチよくしてあげるから……」	「请放松…没关系的。我会让你舒服起来的……」
「お前の愛を、私に注いでくれ♥」	「把你的爱，倾注到我身上吧♥」
「…これでお仕舞いなんて、ないじゃないか…♥」	「…这样的话、就没法逃走了吧…♥」
「ほら見て…私の乳首、もうビンビンだ……♥」	「看吧…我的乳头已经硬起来了呢……♥」
「%ANAME(MASTER)%とシたくてシたくて…堪らないからだよ」	「想要和%ANAME(MASTER)%结合…想地受不了了呢」
「だから、な……シよう♥」	「所以呢...呐……做吧♥」
「ふふ♥　%ANAME(MASTER)%、どこへ行くんだ？　夜はまだこれからだぞ♥」	「fufu♥　%ANAME(MASTER)%、想去哪呢？　夜才刚开始呢♥」
「%ANAME(MASTER)%といると、身体が熱く疼いてたまらないんだ…♥」	「和%ANAME(MASTER)%在一起呢、身体就感觉苦闷骚动着呢…♥」
「だから責任を取って…、%ANAME(MASTER)%のコレで、鎮めておくれ♥」	「所以啊请负起责任...用%ANAME(MASTER)%的这个、将它填满吧♥♥」
「…お前といると、身体が疼いて…とてもいやらしい気分になる…♥」	「…和你在一起的话，身体会觉得苦闷…变得焦躁…♥」
「ほら見て…私のここ、%ANAME(MASTER)%のが欲しくて泣いてる……慰めてくれ♥」	「看吧…我这里，想要%ANAME(MASTER)%的咕噜咕噜地淌着呢……来安慰我吧♥」
「今日はお前に…犯されたいんだ♥」	「今天呐…想被你狠狠侵犯呢♥」
「…すまない、%ANAME(MASTER)%。今日は身体が昂ぶっていてな…」	「…对不起，%ANAME(MASTER)%。今天的身体兴奋过头了…」
「だから私と……セックス、しようか…♥」	「所以啊……和我...做爱吧…♥」
%ANAME(TARGET)%は%ANAME(MASTER)%を押し倒して身体に跨ってきた	%ANAME(TARGET)%推倒%ANAME(MASTER)%跨坐在身体上
「…これでお仕舞いなんて、嫌だぞ…」	「…就这样结束的话、真讨厌呢…」
「ほら、私のおっぱい好きにしていいから……%ANAME(MASTER)%、シよう♥」	「看、你可以尽情责弄我的欧派哦……%ANAME(MASTER)%、做吧♥」
これからの行為を期待して、%ANAME(TARGET)%の表情は蕩けている……	期待着接下来的行为、%ANAME(TARGET)%的表情荡漾着……
%ANAME(TARGET)%は%ANAME(MASTER)%を押し倒した。	%ANAME(TARGET)%把%ANAME(MASTER)%推倒了。
「…お前といると、身体が疼いて…やらしい気分になる」	「…和你在一起的时候，身体会苦闷…感觉很难受」
%ANAME(TARGET)%は%ANAME(MASTER)%に、豊満な胸を押し当てるように抱きつく	%ANAME(TARGET)%把丰满的胸部紧压在%ANAME(MASTER)%的怀里
「ほら…私のここ、寂しくて濡れてる……%ANAME(MASTER)%ので、慰めてくれ♥」	「看…我的这里、寂寞地湿了呢……所以呢%ANAME(MASTER)%，好好抚慰我吧♥」
%ANAME(TARGET)%は%ANAME(MASTER)%を押し倒してきた	%ANAME(TARGET)%把%ANAME(MASTER)%推倒了
「…エッチなこと、しようか♥」	「…来做涩涩的事情吧♥」
%ANAME(TARGET)%は%ANAME(MASTER)%の顔を豊満な胸で包みながら色っぽく囁く	%ANAME(TARGET)%用丰满的胸部包裹着%ANAME(MASTER)%的脸，妖媚地低声私语道
「今日はお前を…犯したい気分なんだ…♥」	「今天也要…好好地侵犯我哦…♥」
%ANAME(MASTER)%は%ANAME(TARGET)%の呼びかけに振り向くと、グイっと引っ張られた	%ANAME(MASTER)%被%ANAME(TARGET)%的呼声所唤而转过头时、被用力拉了过去
%ANAME(TARGET)%は%ANAME(MASTER)%の顔を乳房で包み込みながら妖しく囁く	%ANAME(TARGET)%用乳房裹住%ANAME(MASTER)%的脸，妖艳地低声私语
「ふふふっ♥」	「fufufuっ♥」
%ANAME(TARGET)%は怪しい笑みを浮かべながら%ANAME(MASTER)%を押し倒した	%ANAME(TARGET)%带着妖媚的笑容推倒了%ANAME(MASTER)%
「…お前といると、なぜか身体が疼いて…妙な気分になる」	「…和你在一起的时候，不知为何身体会苦闷…感觉很奇怪」
「…何だか今日は、とてもいい気分なんだ…」	「…总感觉今天...心情特别的好呢…」
「だからなぁ、%ANAME(MASTER)%……私とシておくれよ♥」	「所以啊，%ANAME(MASTER)%……和我在一起吧♥」
「な、なぁ%ANAME(MASTER)%。その…今日……シていかないか？」	「呐，%ANAME(MASTER)%。那个…今天……不走吗？」
%ANAME(TARGET)%は顔を赤くしながらも、豊満な胸を%ANAME(MASTER)%に押し付けておねだりしている…	%ANAME(TARGET)%满脸绯红、用丰满的胸部压着%ANAME(MASTER)%，索求着…
%ANAME(TARGET)%「さて…どうしたものか」	%ANAME(TARGET)%「嗯？…怎么了」
%ANAME(TARGET)%「…ちゃんと妖怪対策はしているか。何とか抜け出す方法はないものか…」	%ANAME(TARGET)%「…能好好地对付妖怪了吗?难道就没有摆脱的方法吗…」
%ANAME(TARGET)%「はぁ…%ANAME(MASTER)%の傍にいてやりたいというのに……」	%ANAME(TARGET)%「啊…明明想待在%ANAME(MASTER)%的身边……」
%ANAME(TARGET)%「朗報を期待していてくれ」	%ANAME(TARGET)%「期待您的好消息」
%ANAME(TARGET)%「%ANAME(MASTER)%、気をつけてな」	%ANAME(TARGET)%「%ANAME(MASTER)%、小心点啊」
%ANAME(TARGET)%「さて、出かけるか」	%ANAME(TARGET)%「PRINTFORML %ANAME(TARGET)%「那么、出发吧」
%ANAME(TARGET)%「早く乱世を終わらせないとな。……%ANAME(MASTER)%のためにも」	%ANAME(TARGET)%「必须早点结束乱世啊……为了%ANAME(MASTER)%」
%ANAME(TARGET)%「九尾の力を見せてやろう」	%ANAME(TARGET)%「让你看看九尾的力量吧」
%ANAME(TARGET)%「少しでも幻想郷をさっぱりさせんとな」	%ANAME(TARGET)%「哪怕是一点点也好，想让幻想乡清静一点啊」
%ANAME(TARGET)%「荒事は好きではないのだが……言ってられる世情でもないか」	%ANAME(TARGET)%「我实在不喜欢战斗……不过现在也不是就这样推辞的时候了吧」
%ANAME(TARGET)%「%ANAME(MASTER)%、危なくなったら私を呼ぶんだぞ」	%ANAME(TARGET)%「%ANAME(MASTER)%、危险的话必须叫我啊」
%ANAME(TARGET)%「今の時代にこんな乱世を生きるとはな…」	%ANAME(TARGET)%「没想到在这个时代会处于这样的乱世中…」
%ANAME(TARGET)%「%ANAME(MASTER)%、いってらっしゃい。危ないと思ったらすぐ逃げるんだぞ」	%ANAME(TARGET)%「%ANAME(MASTER)%、请慢走。一觉得危险就马上撤退」
%ANAME(TARGET)%「さて、行ってくるか」	%ANAME(TARGET)%「那么，我出发了」
%ANAME(TARGET)%「今の時代にこんな乱世が来るとはな…」	%ANAME(TARGET)%「没想到在这个时代竟然会有这样的乱世到来…」
%ANAME(TARGET)%「忙しいのはいつもの事だな」	%ANAME(TARGET)%「繁忙可是常有的事啊」
%ANAME(TARGET)%「何とか逃げ出せないものか…」	%ANAME(TARGET)%「看来怎么也逃不掉啊…」
%ANAME(TARGET)%「…九尾の身体が泣いてるな…」	%ANAME(TARGET)%「…九尾的身体在哭泣呢…」
%ANAME(TARGET)%「%ANAME(MASTER)%は無事だろうか。…くっ、私は何をやっているんだ……」	%ANAME(TARGET)%「%ANAME(MASTER)%「%ANAME(MASTER)%不会有事吧。…呜，我到底在做什么呢……」
%ANAME(TARGET)%「今回も無事、帰って来れたか」	%ANAME(TARGET)%「这次也平安无事地归来了呢」
%ANAME(TARGET)%「お疲れ様、%ANAME(MASTER)%。怪我は無かったか？」	%ANAME(TARGET)%「辛苦了，%ANAME(MASTER)%。没有受伤吧？」
%ANAME(TARGET)%「お帰り、%ANAME(MASTER)%。ご飯の支度は出来ているが食べていくか？」	%ANAME(TARGET)%「欢迎回来、%ANAME(MASTER)%。饭已经准备好了，要吃吗？」
%ANAME(TARGET)%「お帰り、%ANAME(MASTER)%。お風呂の準備は出来ているがどうする？」	%ANAME(TARGET)%「欢迎回来、%ANAME(MASTER)%。浴室已经准备好了，要怎么办？」
%ANAME(TARGET)%「九尾の力でも簡単には行かんな…」	%ANAME(TARGET)%「用九尾的力量也不能轻易解决啊…」
%ANAME(TARGET)%「世を治めるというのは一筋縄では行かないものだな…」	%ANAME(TARGET)%「所谓治世，用普通的办法是不行的…」
%ANAME(TARGET)%「%ANAME(MASTER)%に会えない間……寂しかったよ」	%ANAME(TARGET)%「在见不到%ANAME(MASTER)%的期间……好寂寞啊」
%ANAME(TARGET)%「%ANAME(MASTER)%、お帰りなさい。そっちはどうだった？」	%ANAME(TARGET)%「%ANAME(MASTER)%、欢迎回来。那边状况如何？」
%ANAME(TARGET)%「%ANAME(MASTER)%、お帰りなさい。しばらくはゆっくり出来そうだな」	%ANAME(TARGET)%「%ANAME(MASTER)%、欢迎回来。看来可以暂时缓一缓了」
%ANAME(TARGET)%「怪我は無いか？　そうか…お前がちゃんと帰ってきて良かったよ」	%ANAME(TARGET)%「没有受伤吧？是吗…你能好好回来真是太好了……」
%ANAME(TARGET)%「ふう…、帰って来れたか」	%ANAME(TARGET)%「嗯…你回来了吗」
%ANAME(TARGET)%「世を治めるというのは一筋縄では行かないものだな」	%ANAME(TARGET)%「用普通的办法是无法治世的」
%ANAME(TARGET)%「徴兵に治安維持に資金調達…。帰ってからも忙しくなりそうだ」	%ANAME(TARGET)%「为征兵和维持治安要筹措资金…。回去以后也要忙起来呢」
「は、はい…。…私は、貴方に忠誠を誓います…」	「好的，是……我向你效忠…」
「だ、誰が…そんな…っ」	「啊…这样啊…还不行」
「うむ、分かった。これからよろしく頼むぞ」	「嗯，知道了。今后请多关照」
「すまない。そう易々と決めるわけにはいかないんだ」	「对不起。这事不能那么轻松地决定」
「……分かった。これからよろしく頼む」	「……知道了。今后请多关照」
「…この程度で心変わりすると思うか？」	「…你觉得这样会变心吗？」
（…式神である私が、こんな感情を持つなんて…）	（…身为式神的我，竟然有这样的感情…）
「でもこの気持ちは偽物じゃない……そうだよな、%ANAME(MASTER)%……」	「但是这份心情并不是假的……是啊，%ANAME(MASTER)%……」
（%ANAME(MASTER)%のためなら何でも出来そうだ…これが仁の心というものだろうか…）	（为了%ANAME(MASTER)%的话好像什么都会做…这就是仁心吗…）
（…私がこんなにも誰かに惚れ込むだなんてな…）	（…我怎么会这么迷恋他人呢…）
（でも嫌じゃない……むしろとても幸せな気持ちだ…ああ、これが…）	（但是并不讨厌这样……倒不如说是非常幸福的心情…啊，这是…）
（『愛する』ってことなんですね…紫様…）	（这就是所谓的"爱"吧…紫大人…）
「もっと、もっとシてぇっ♥　キモチいいのがっ♥止まらないぃ♥♥」	「还要、还要更多♥　好舒服~♥停不下来啊♥♥」
%ANAME(TARGET)%はもはや、性交に一切の抵抗を感じていない。	%ANAME(TARGET)%已经对性交没有任何抵抗了。
それどころかさらに快感を貪るため、自らより激しく腰を振っている	不仅如此，为了更加贪图快感，她自己更激烈地摆动着腰
（こんなはしたない私でごめんよ、%ANAME(MASTER)%…。でも、もう自分を抑えられない！）	（这么失态…对不起，我是个淫荡的人，%ANAME(MASTER)%…但是，已经无法抑制自己了！）
「ああっ♥　キモチいいっ♥　キモチいいぃっ♥♥　キモチいいぃぃっ♥♥♥　もっと、もっとぉっっ♥♥♥♥」	「啊啊啊~♥　好舒服呀♥　真舒服呢♥♥　感觉太棒了♥♥♥　再来...更多~♥♥♥♥」
瞳に♥を浮かばせ、更なる快感を貪るために腰を浮かせる%ANAME(TARGET)%	瞳中的♥浮现着、为了贪图更进一步的快感而使之浮起腰的%ANAME(TARGET)%
滴り落ちるほど愛蜜を滴らせ、肉壷で肉棒を咥えこむその姿は	滴落的爱液流淌着，用肉壶吞没肉棒的淫态呈现着
誇りある式神のそれではなく、愛欲に溺れる九尾の獣そのものだった……	不再是自高自傲的式神、而是沉迷于爱欲的九尾之兽……
「ああっ♥　クリだめぇっ♥♥　頭バカになっちゃうぅ♥♥」	「啊啊啊~♥　阴蒂那不行...♥♥　脑袋快变成⑨了♥♥」
数々の快感によって開発されきった%ANAME(TARGET)%のクリトリスは	受到了无数快感而被开发的%ANAME(TARGET)%的阴蒂
尋常でない快楽で脳を蕩かす淫核と化した	因为异常的快乐而化为淫核
「あっ♥ああっ♥♥ダメぇっ♥♥　クリいじっちゃダメぇっ♥♥　こわれちゃうからぁっ♥♥」	「啊♥嗯啊♥♥不行啊♥♥不能这样责弄那♥♥会坏掉的~~♥♥」
そう言いながら%ANAME(TARGET)%はクリへの責めを一切邪魔せず、瞳に♥を浮かばせて更なる快感を貪っている…	这样说着的%ANAME(TARGET)%对于阴蒂的刺激却完全没有抵抗、瞳中的♥浮现着贪图着更多的快感…
「ああっ♥♥　もっとっ♥♥もっと奥っ♥♥　奥まで犯してぇっ♥♥」	「啊啊啊♥♥更多~~♥♥再戳一点♥♥要侵犯到深处里~~♥♥」
数々の快感によって開発されきった%ANAME(TARGET)%の雌穴は、	受到了无数快感而被开发的%ANAME(TARGET)%的小穴
入り込んだ肉棒に吸い付き精液を搾り取ろうと蠢く淫壷と化した	化为了只为肉棒精液的淫壶
「チンポ…♥もっとチンポ…♥　チンポ突っ込んでぇっ♥♥♥」	「欧金金…♥还要欧金金…♥更多地突入里面吧♥♥♥」
瞳に♥を浮かばせ、肉棒をねだる%ANAME(TARGET)%	%ANAME(TARGET)%眼中浮现着♥渴求着肉棒
彼女はもはや、肉棒無しの生活など考えられない身体となった…	她的身体已经无法想象没有肉棒生活…
「ああっ♥♥もっとっ♥♥もっと突いてっ♥♥もっとズポズポしてぇっ♥♥」	「啊啊啊♥♥更多♥♥再戳一点♥♥再噗嗤噗嗤地插我吧♥♥」
本来知ることの無かった快感に晒され続けた%ANAME(TARGET)%の尻穴は	一直沉浸在一种从未有过的快感中,%ANAME(TARGET)%的尻穴
もはや巨根であっても躊躇無く咥え込み、快楽を貪る性感帯となった	即使是巨根也能毫不犹豫地叼入，成为贪图快乐的性感带
「あぁっ♥こんなっ♥お尻でぇっ♥ひあぁっ♥♥♥」	「啊♥就这样♥用屁穴~♥啊啊啊啊~~♥♥♥」
九本の尻尾を乱れさせながら瞳に♥を浮かばせ、蕩けきった表情を見せる%ANAME(TARGET)%	%ANAME(TARGET)%九尾胡乱扫动着眼中浮现着♥露出了淫荡的表情
彼女はもはや、立派な尻穴狂いとなった…	她已经成了优秀的菊穴狂…
「あぁっ♥♥　%ANAME(TARGET)%のおっぱいっ♥　もっと揉んでっ♥♥乳首イジってぇっ♥♥」	「啊嗯♥♥%ANAME(TARGET)%的欧派♥再多揉揉♥♥乳头要疯了啊啊啊~♥♥」
数々の快感によって開発されきった%ANAME(TARGET)%の胸は	受到了无数快感而被开发的%ANAME(TARGET)%的胸
愛撫を待ち望み、たやすく絶頂する淫乳と化した	渴望着爱抚，变成了能轻易达到顶点的淫乳
「はぁぁ…♥♥　もっと%ANAME(TARGET)%のおっぱい、めちゃくちゃにしてぇ♥♥」	「啊啊啊…♥♥　更多地蹂躏%ANAME(TARGET)%的欧派...让我变得乱七八糟吧♥♥」
%ANAME(TARGET)%は自らも胸を揉みしだき、さらなる快楽を貪っている…	%ANAME(TARGET)%自己也在揉胸，贪图着更进一步的快乐…
「ああ、もっと♥　もっと私を抱いてください♥」	「啊，更多♥请再多多抱我♥」
男を誘うような媚びた色気を振りまき、%ANAME(TARGET)%は更なる性交をねだる	散发着诱惑男人般的媚态，%ANAME(TARGET)%要求更进一步的性交
（大丈夫。これはお金の、軍資金のためだから…これは仕方ないことだから……♥♥）	（没关系。这是为了钱、军费的…这是没办法的事……♥♥）
%ANAME(TARGET)%は自らの行いを資金調達のためと言い聞かせ、はした金で下卑た輩に犯される背徳の快楽に溺れていった……	%ANAME(TARGET)%把自己的行为说成是为了筹措资金，沉溺在被下贱之辈侵犯的背德快乐中……
「ああっ♥　もっと突っこんでぇ♥　%ANAME(TARGET)%の奥で出してぇっ♥♥」	「啊啊啊♥　在深入些~♥在%ANAME(TARGET)%的里面尽情享受吧♥♥」
生ハメを繰り返した%ANAME(TARGET)%の肉壷は、生の肉棒に抉り突かれ、吐き出される精の虜となってしまった	重复抽插着%ANAME(TARGET)%的肉壶，被无套中出着，成为了精液的俘虏
もはや%ANAME(TARGET)%は、ゴム有りのセックスなど考えられないだろう……	%ANAME(TARGET)%已经无法想象带避孕套的性生活了吧……
「いくらでも♥　出していいぞ♥　ああっ♥　もっとっ♥　もっと出してぇっ♥　おまんこの奥に塗りこんでぇッ♥」	「全部都...♥....都射出来吧♥　啊啊♥　还要更多♥　再多多射在深处吧♥」
「%ANAME(MASTER)%、どうかしたのか？」	「%ANAME(MASTER)%，怎么了？」
%ANAME(MASTER)%は呼び出された%ANAME(TARGET)%と向かい合って指輪を差し出した	%ANAME(MASTER)%深情地凝望着被叫出来的%ANAME(TARGET)%，然后送出了戒指
「！！？　…っ…%ANAME(MASTER)%、これって…！」	「！！？…啊…%ANAME(MASTER)%、这是…！」
見たとおりの意味だ。受け取ってくれるだろうか	如你说见的意思，能接受吗？
「っ！　………そ、それじゃあ…駄目、だ…」	「呃！………那、那样子…不，不行…」
……駄目、とはこの気持ちを受けてはくれない、ということだろうか……	……不行么、也就是说不能接受我的这种心情吧……
「ち、ちがうっ！　そういうことじゃなくて！」	「不、不是的！不是那样的！」
%ANAME(TARGET)%は慌てた様子で%ANAME(MASTER)%の手を握る。その顔は真っ赤で、目元もうっすらと潤んでいた	%ANAME(TARGET)%看起来很慌张，急忙握着%ANAME(MASTER)%的手。那张脸通红，眼睛也微润着
「…確かに意味は解る。でもそれだけじゃなくて…。ちゃんと…%ANAME(MASTER)%の口から、言葉で伝えて欲しいんだ…」	「…确实收到了那份心情。但是不仅仅是这样…那个...想从%ANAME(MASTER)%口中听到...好好的表达出来...那个…」
普段の凛とした佇まいとは大違いの様子で弱々しく語り%ANAME(TARGET)%は俯く。…そういうことか。確かに誠意が足りなかった	和平时凛然的样子大不相同，低着头弱弱地说着的%ANAME(TARGET)%。…是这样吗！缺乏诚意是吗
%ANAME(MASTER)%は%ANAME(TARGET)%の手を取り、面と向かって再び告げる	%ANAME(MASTER)%握着%ANAME(TARGET)%的手，面对面再次告白着
%ANAME(TARGET)%のことを愛している。自分と結婚して欲しい。と……	我深爱着%ANAME(TARGET)%，想与之成婚，能答应我吗……
「………っ！！」	「………！！」
%ANAME(TARGET)%はその言葉を聞くと、感極まったように涙を流し%ANAME(MASTER)%に抱きついてきた	%ANAME(TARGET)%闻言，感动得抱住%ANAME(MASTER)%哭了出来
「%ANAME(MASTER)%っ…嬉しいっ…嬉しいよ！　%ANAME(MASTER)%…！」	「%ANAME(MASTER)%~…我好开心…好高兴！%ANAME(MASTER)%…！」
「ずっと不安だったんだ…、愛しているのは私だけなんじゃないかって……」	「我一直很不安…难道只有我在单相思吗……」
「でも、そうじゃなかったんだな……。私を、一人の女として愛してくれるんだな……っ」	「但是、并不是那样……你也爱着我啊……」
%ANAME(TARGET)%はさっきまでの不安そうな顔つきではなく、幸せそうに緩んだ泣き顔で返事を告げる	%ANAME(TARGET)%刚刚那不安烟消云散，幸福得哭得梨花带雨着回复道
「私も貴方を愛しています。私を、%ANAME(MASTER)%のお嫁さんにしてください…♥」	「我也爱你。请让我成为%ANAME(MASTER)%的妻子吧…♥」
「……♥……ふふ♥」	「……♥……fufu~♥」
婚姻の儀の最中、%ANAME(TARGET)%は自らの薬指に輝く指輪を何度も見ては、幸せそうに頬を緩ませている	结婚仪式上，%ANAME(TARGET)%多次看着自己无名指上闪耀着的戒指，幸福的微笑着
儀も滞りなく進み、そろそろ終わりになろうかというところに、突如雨が降ってきた	仪式也顺利进行着，就在要结束的时候，突然下起了雨
日差しも眩しい晴れ間にも関わらず、ぽつぽつと天気雨が降り注ぐ…	即使是耀眼的晴天，也会淅淅沥沥地下着太阳雨…
― 天気雨は狐の嫁入りとも言うが、本当に嫁入りの時に降ってくるとはなぁ ―	―― 虽然太阳雨也叫狐狸出嫁，但真的是出嫁的时候下的啊 ――
「…もしかしたら、龍神様が私たちの事を祝ってくれたのかもしれないな」	「…也许，是龙神大人为了祝福我们而庆祝的吧」
%ANAME(TARGET)%は雨の中も、ずっと%ANAME(MASTER)%に寄り添っていた	即使在雨中，%ANAME(TARGET)%也一直依偎在%ANAME(MASTER)%身边
（紫様…私には、今でも貴女のお考えが分かりません…）	（紫大人…我至今还不明白你的想法…）
（この結婚も、式の分際で、とお怒りになるのでしょうか。それとも%ANAME(TARGET)%の幸せを祝ってくれるのでしょうか…）	（以式神的身份与他人成婚，您会生气吗，还是会为%ANAME(TARGET)%的幸福所祈祷祝福呢…）
（…考えても詮無き事ですが、それでも、私は紫様に感謝しています）	（…虽然想也没用，但是我还是很感谢紫大人）
（私に心をくれて、ありがとうございます。この人を愛する心をくれて、本当にありがとうございます）	（谢谢你关心我。谢谢你给了我能爱这个人的心）
（…私は、紫様の式でいられて本当に幸せでした。そしてこれからの幸せを守るため、藍は頑張っていきます…）	（…我能成为紫大人的式神真的很幸福。然后为了守护这份幸福，蓝会努力的…）
静かに寄り添う%ANAME(TARGET)%の目元にうっすらと涙が浮かぶ。何かあったのだろうか？	静静贴近的%ANAME(TARGET)%的眼睛里隐约地浮现出泪水。发生了什么事吗？
「ん？　ふふっ。いや、なんでもないんだ。ちょっとした嬉し涙だよ。あ、空…」	「嗯？fufu。不，没什么。有点高兴罢了。啊，天空…」
天気雨はもう上がっていた。青空には二人を祝うかのように、鮮やかな虹がかかっていた……	太阳雨已经停了。蓝天上挂着鲜艳的彩虹，好像是在祝福两个人
「%ANAME(MASTER)%…%ANAME(MASTER)%…、んんっ！　…♥…あぁっ♥」	「%ANAME(MASTER)%…%ANAME(MASTER)%…嗯，嗯！　…♥…啊啊啊♥」
「……ぁ、んんっ……」	「……啊，嗯……」
「んっ！　……ふうっ！」	「嗯！　……呼呜！」
「ううぅ……そんな殺生なぁ…」	「呜呜……太残忍了啊…」
「ふふ…いいぞ。なんだかとても…シたい気分だ…♥」	「ufu…行啊。总觉得有总…无法拒绝的感觉…♥」
%ANAME(TARGET)%は酔いが深いのか、トロンとした表情で%ANAME(MASTER)%にもたれかかって来た	%ANAME(TARGET)%可能是醉意很浓，带着矫情的表情靠在了%ANAME(MASTER)%上
「…待っていたぞ、%ANAME(MASTER)%♥」	「…我等着你，%ANAME(MASTER)%♥」
「ふふ…その誘い、乗ってやろう」	「fufu…我就接受你的邀请吧」
「誘い方がなってないぞ」	「无法接受你的引诱呢」
%ANAME(MASTER)%は%ANAME(TARGET)%に手をつねられた	%ANAME(MASTER)%被%ANAME(TARGET)%掐了手
「……もっと精進しろ」	「……少得意忘形了」
「ふふ…九尾を誘惑するなんて。よほど搾られたいんだな%ANAME(MASTER)%は♥」	「fufu…居然诱惑九尾。这么想被榨取吗？%ANAME(MASTER)%桑~♥」
%ANAME(TARGET)%は%ANAME(MASTER)%にしなだれかかり、手際よく服を剥ぎ取っていく	%ANAME(TARGET)%受%ANAME(MASTER)%所诱、熟练地脱下了衣服
「求められてとっても嬉しいよ♥　それでは望み通り、たっぷりよがらせてあげるからな」	「被索求了非常开心哦♥那么我会按照你的愿望，充分地榨干你哦」
%ANAME(TARGET)%は妖艶な笑みを浮かべ、%ANAME(MASTER)%の体に自身の尻尾を絡めてくる	%ANAME(TARGET)%露出妖艳的笑容，将自己的尾巴缠绕在%ANAME(MASTER)%的身上
「さあ、今夜はもう放さないぞ…、愛しい私の旦那様♥」	「那么、今天是不会放过你的哦…我亲爱的夫君大人♥」
「ふふ、%ANAME(MASTER)%の方から誘ってくれるなんて、とても嬉しいぞ♥」	「fufu，能受到%ANAME(MASTER)%的邀请，我很高兴哦♥」
%ANAME(TARGET)%は満面の笑みを浮かべて%ANAME(MASTER)%に抱きついてきた	%ANAME(TARGET)%满面笑容地抱住了%ANAME(MASTER)%
「それじゃあ今夜も私を愛してくれ…旦那様…♥」	「那么今晚也请爱我…夫君大人…♥」
「ああ♥　もう待ちわびていたんだぞ♥」	「啊♥　已经等不及了♥」
%ANAME(TARGET)%は、%ANAME(MASTER)%の誘惑に乗って、尻尾を乱れ振りながら抱きついてきた	%ANAME(TARGET)%顺着邀请乱摇着尾巴抱住了%ANAME(MASTER)%
「ああっ、もう我慢できない！　早く抱かせておくれよ、私の旦那様♥」	「啊，已经不能忍耐了！快点抱我，我的夫君♥」
「ふふふ、いいのか？　搾り取られても知らないぞ♥」	「fufufu、可以吗？被榨干了我也不管哦♥」
耳元で熱っぽく囁きながら、%ANAME(MASTER)%の股間を撫で回す。その一物は既にはち切れそうになっている	在耳边一边热地低声细语着，一边来回抚摸着%ANAME(MASTER)%的胯间，那话儿已经快要撑爆了
「…なんて、無粋だな。私に搾り取られたいから誘ってきたんだものなぁ♥」	「…忍耐是无意义的呢。就是因为想被我榨取才邀请我的吧♥」
「望みどおり、たっぷり搾り取ってあげるぞ、可愛い私の旦那様♥」	「我会按照你的愿望好好榨取你的，我可爱的夫君大人♥」
「それでは望み通り、たっぷりよがらせてあげるからな」	「那么我会按照你的愿望，充分地榨干你哦」
%ANAME(TARGET)%は妖艶な笑みを浮かべ、%ANAME(MASTER)%の身体に自身の尻尾を絡めてくる	%ANAME(TARGET)%露出妖艳的笑容，将自己的尾巴缠绕在%ANAME(MASTER)%的身体上
「さあ、今日はもう放さないぞ…♥」	「那么、今天是不会放过你的哦…♥」
「そちらから誘ってくれるなんて、とても嬉しいぞ♥」	「能邀请我做、很开心哦♥」
「それじゃあ%ANAME(MASTER)%…。今日も私を愛してくれ♥」	「那么%ANAME(MASTER)%…。今天也请爱我♥」
%ANAME(TARGET)%は、%ANAME(MASTER)%の誘惑に乗って抱きついてきた	%ANAME(TARGET)%顺着邀请抱住了%ANAME(MASTER)%
「ああっ、もう我慢できない！　早く%ANAME(MASTER)%を抱かせておくれ♥」	「啊、已经不能忍耐了！快点抱我吧%ANAME(MASTER)%♥」
「ふふふ、いいのか？　搾り取られても知らんぞ♥」	「fufufu、可以吗？被榨干了也没事吗♥」
「…なんて、野暮なことだな。私に搾り取られたいから誘ってきたんだものなぁ♥」	「…多么地没出息呢。就是因为想被我榨取才邀请我的吧♥」
「うふふ…九尾を誘惑するとは。どういうことか、分かっているのか%ANAME(MASTER)%は♥」	「fufu…竟然诱惑九尾，你知道会发生什么事吗%ANAME(MASTER)%桑♥」
「お望み通り、いっぱいキモチよくしてあげよう♥」	「如你所愿，让你舒服起来吧♥」
「ふふ、そっちから誘ってくれるとは手間が省けたな♥」	「fufu、你来邀请我，真是省去了麻烦啊♥」
「ん♥　待ちわびていたぞ♥」	「嗯♥ 等你开口好久了♥」
%ANAME(TARGET)%は耳元で熱っぽく囁きながら、%ANAME(MASTER)%の股間を撫で回してきた	%ANAME(TARGET)%在耳边热切地私语着，抚摸着%ANAME(MASTER)%的胯间
「ふっ、搾り取られても知らんぞ？」	「豁...被榨干了也没关系是吗？」
%ANAME(TARGET)%「よし、いこうか」	%ANAME(TARGET)%「好，出发吧」
%ANAME(TARGET)%「九尾の力を舐めるなよ」	%ANAME(TARGET)%「不要小看九尾的力量」
%ANAME(TARGET)%「荒事は本業ではないのだがな」	%ANAME(TARGET)%「虽然战斗不是我擅长的，但没办法了呢」
%ANAME(TARGET)%「美しさの無い戦いは好まないが…、そうも言ってられんか」	%ANAME(TARGET)%「我不喜欢没有美感的战斗，但我想我不能这样说」
%ANAME(TARGET)%「命を無駄にするのは関心せんぞ」	%ANAME(TARGET)%「我对不惜命的家伙可不感兴趣」
%ANAME(TARGET)%「反抗する限りは容赦はせんぞ」	%ANAME(TARGET)%「反抗的话杀无赦」
%ANAME(TARGET)%「最強の妖獣の力がどんな物か、教えてやろう」	%ANAME(TARGET)%「让我来告诉你最强妖兽的力量是怎样的」
%ANAME(TARGET)%「ええい、手間を掛けさせてくれるな」	%ANAME(TARGET)%「就这样，别让我费劲了」
%ANAME(TARGET)%「落としてみせる！」	%ANAME(TARGET)%「陨落吧！」
%ANAME(TARGET)%「九尾の力、見せてやろう！」	%ANAME(TARGET)%「让你看看九尾的力量！」
%ANAME(TARGET)%「荒事は本意ではないが、仕方あるまい」	%ANAME(TARGET)%「虽然战斗不是我擅长的，但没办法了呢」
%ANAME(TARGET)%「降伏してくれれば無駄に争わなくて済むのだが…」	%ANAME(TARGET)%「如果投降的话，就不用白白斗争了…」
%ANAME(TARGET)%「抵抗する限り、容赦はせんぞ」	%ANAME(TARGET)%「如若抵抗，杀无赦」
%ANAME(TARGET)%「九尾を相手にして、ただで済むと思うな」	%ANAME(TARGET)%「别以为和九尾交手能轻易逃脱」
%ANAME(TARGET)%「伊達で紫様のお供をしているわけではない。見くびってくれるな！」	%ANAME(TARGET)%「我可不是只是紫大人随从。别小看我！」
%ANAME(TARGET)%「攻める以上は容赦せん。覚悟しろ」	%ANAME(TARGET)%「既然是侵略就无法手下留情。觉悟吧」
%ANAME(TARGET)%「九尾を相手に何処まで出来るか、見せてみよ！」	%ANAME(TARGET)%「让我来看看你能和九尾对抗到什么程度!」
%ANAME(TARGET)%「守り抜いてみせる！」	%ANAME(TARGET)%「我会守护你的！」
%ANAME(TARGET)%「荒事は本意ではないが、そうも言ってられんな」	%ANAME(TARGET)%「虽然战斗不是我擅长的，但已经不是能这么说的时候了呢」
%ANAME(TARGET)%「私がいる以上、簡単には落とさせん」	%ANAME(TARGET)%「既然有我在，那么就不会轻易落败」
%ANAME(TARGET)%「九尾を討ち取れるつもりか？」	%ANAME(TARGET)%「打算与九尾相斗吗？」
%ANAME(TARGET)%「ここを簡単に落とせるとは思って欲しくないな」	%ANAME(TARGET)%「我可不认为你能在这把我轻易解决掉」
%ANAME(TARGET)%「最強の妖獣の力、伊達ではないと教えてやろう！」	%ANAME(TARGET)%「被称为最强妖兽之力可不是平白而来的！」
%ANAME(TARGET)%「九尾に手を出すとは、命知らずか命いらずか…」	%ANAME(TARGET)%「惹上九尾，就是死路一条，真是不惜命... ...」
%ANAME(TARGET)%「九尾の力は伊達ではないと教えてやろうか」	%ANAME(TARGET)%「我来告诉你最强妖兽之名可不是凭空捏造的！」
%ANAME(TARGET)%「出来る限りの抵抗はしてやる。覚悟しろ！」	%ANAME(TARGET)%「我会尽力抵抗的。觉悟吧！」
%ANAME(TARGET)%「知恵と力を持って、凌ぎ切って見せよう」	%ANAME(TARGET)%「用智慧和力量，来克服它吧」
%ANAME(TARGET)%「これが私の流儀だ」	%ANAME(TARGET)%「这就是我的作风」
%ANAME(TARGET)%「力押しよりこちらが得意でな」	%ANAME(TARGET)%「比起武力，我更擅长这个」
%ANAME(TARGET)%「力ある者がいつも勝つとは限らんぞ」	%ANAME(TARGET)%「关有武力的家伙不是总能取胜的呢」
%ANAME(TARGET)%「私の本領をお見せしよう」	%ANAME(TARGET)%「然你看看式神的本事吧」
%ANAME(TARGET)%「思い描いた通りに戦局が動くのは痛快だな」	%ANAME(TARGET)%「战局如我所料在运转，真是令人兴奋」
%ANAME(TARGET)%「なんだと！？」	%ANAME(TARGET)%「什么！？」
%ANAME(TARGET)%「そちらが上手だったか…！」	%ANAME(TARGET)%「不错的一手嘛…！」
%ANAME(TARGET)%「向かう先は悪天候ばかり、か…」	%ANAME(TARGET)%「净是坏消息吗，呜…」
%ANAME(TARGET)%「なかなか順風満帆とはいかぬものだな…」	%ANAME(TARGET)%「怎么也不能一帆风顺呢…」
%ANAME(TARGET)%「我が一撃、受けてみろ！」	%ANAME(TARGET)%「吃我一击！！」
%ANAME(TARGET)%「九尾の力をお見せしよう」	%ANAME(TARGET)%「让你们看看九尾的力量！」
%ANAME(TARGET)%「最強の妖獣の力は伊達ではないぞ」	%ANAME(TARGET)%「最强的妖兽之力可不止这一点呢」
%ANAME(TARGET)%「%ANAME(MASTER)%に良いところを見せたいのでな」	%ANAME(TARGET)%「想让%ANAME(MASTER)%看到出色的表现呢」
%ANAME(TARGET)%「下手を打ったか……」	%ANAME(TARGET)%「下了手坏棋吗……」
%ANAME(TARGET)%「私としたことが……」	%ANAME(TARGET)%「我没能做到吗……」
%ANAME(TARGET)%「…もう抵抗はせんよ」	%ANAME(TARGET)%「…无法抵抗了啊」
%ANAME(TARGET)%「敗軍の将ゆえ文句は言えんが…、何故こんな胸を強調する縛り方をする？」	%ANAME(TARGET)%「因为我是败军之将，所以我不能抱怨，但为什么要把我绑得这么突出我的胸部？」
%ANAME(TARGET)%「…終わるときはあっけないものだな…」	%ANAME(TARGET)%「…就这样结束可太没有意思了呢…」
「…仕方あるまい。これからよろしく頼む」	「…没办法。今后请多关照」
「断る」	「我拒绝」
「私にも立場がある。そういうわけには行かない」	「我有我的立场。不能答应」
「…すまないが、その提案は呑めない」	「…对不起，我无法接受这个提案」
「…本気か？　大した度量だ…」	「…真的吗？ 了不起的气量啊…」
「放してくれるというのか？　…かたじけない」	「你要释放我吗？　…非常感谢」
「無事に帰してくれるとは…。すまない、恩に着る」	「我没想到会让我安全离开... ...抱歉，我欠你的」
「やれやれ…どうしたものか…」	「啊啦啊啦…怎么变成这样了呢…」
（すみません、紫様…。%ANAME(TARGET)%はここまでです…）	（对不起，紫大人…。%ANAME(TARGET)%到此为止了…）
%ANAME(TARGET)%「紫様…%ANAME(MASTER)%…お役に立てず……」	%ANAME(TARGET)%「紫大人…%ANAME(MASTER)%…没能帮上忙呢……」
%ANAME(TARGET)%「紫様…申し訳ありません…。%ANAME(TARGET)%はここまでです……」	%ANAME(TARGET)%「紫大人…非常抱歉…%ANAME(TARGET)%到此为止了……」
「…本気か？　…まあ、ひとまずは感謝する」	「…真的吗？　…啊，暂且多谢了」
「九尾の恨み、努々忘れんことだ」	「九尾的怨恨，可别忘记了啊」
「紫様…申し訳ありません…。%ANAME(TARGET)%はここまでです……」	「紫大人…非常抱歉…。%ANAME(TARGET)%到此为止了……」
「…下種めッ」	「…下贱的家伙」
（この屈辱…忘れんぞ…っ！）	（这份屈辱…我可不会忘记的…啊）
「縁が無かった、ということか」	「该说是没有缘分吗、抱歉」
