「……私に何か？」	「嗯？谁在呼唤我？」
捕虜用にあてがわれた部屋にて、九本の大きな尻尾を持った美女が%ANAME(MASTER)%の呼びかけに応える	在被俘用的房间里，有九条大尾巴的美女回应了%ANAME(MASTER)%的召唤
―――――　すきま妖怪の式　『%NAME_FORMAL(TARGET)%』　―――――	———— 隙间妖怪之式神 "%NAME_FORMAL(TARGET)%"————
―――――　珍しい動物　『%NAME_FORMAL(TARGET)%』　―――――	—————— 传说中妖怪 "%NAME_FORMAL(TARGET)%"——————
―――――　策士の九尾　『%NAME_FORMAL(TARGET)%』　―――――	―――　策士の九尾　《%NAME_FORMAL(TARGET)%》————
%ANAME(MASTER)%はその美貌にしばし見とれる	%ANAME(MASTER)%被她的美貌所惑而一时出神
肌の露出がまるで無いにも拘らず色気を放つ肉体と、艶々な毛並みの尻尾が視線を釘付けにする…	虽然完全没有露出皮肤，但却被散发着魅力的肉体和艳丽毛发的尾巴吸引了视线…
「…まぁ、そういう目線には慣れております。それで、私に何か用ですか？」	「……嘛，我已经习惯了这种视线。那么，你想让我做什么？」
視線がどこに向かったか、お見通しのようだ	视线朝着哪里看去了，好像在预料之中
誤魔化しの咳払いの後%ANAME(MASTER)%は、この乱世を鎮めるため我が軍に力を貸して欲しい、と伝えた	心虚的咳嗽之后%ANAME(MASTER)%说，为了平定这个乱世，希望借助其力量。
「……私を牢に繋がず、この扱いをするのはそういうことでしたか」	「……不把我关在牢狱里，就是有求于我吗」
「ですが、そう易々と宗旨替えするわけにはいきません。私にも誇りはありますので……」	「但是，不能那么轻易地改变宗旨。我也有自豪感……」
……やはりそう簡単には行かないようだ	……看来还是不那么容易说服呢
しかし彼女を諦めるというのもあまりに惜しい。根気強く交流を続けて心変わりを願おう	但是放弃她也太可惜了。请耐心地继续交流，以期其能改变心意
「…諦めるつもりは無いようですね……、はあ……」	「…好像没有放弃的打算呢……啊……」
「…どれくらいの付き合いになるか分かりませんが、とりあえずはよろしく、%ANAME(MASTER)%殿」	「…虽然不知道会发生多少交集，总之请多关照，%ANAME(MASTER)%大人」
「ん？　私に用か？」	「嗯？你找我吗？」
「ん？　私ですか？」	「嗯？叫我吗？」
九本の大きな尻尾を持った美女が%ANAME(MASTER)%の呼びかけに応えて振り向く	有九只大尾巴的美女响应%ANAME(MASTER)%的召唤而回头
「えーと、君は確か…%ANAME(MASTER)%だったかな？」	「嗯…你是那个…是%ANAME(MASTER)%吗？」
直接の面識は無くとも、部下である%ANAME(MASTER)%の顔と名前は覚えられているようだ	即使没有相识，作为部下的%ANAME(MASTER)%的脸和名字也能记住
問いに肯定を返した%ANAME(MASTER)%は、君主である%ANAME(TARGET)%に挨拶に伺わせていただきました、と伝えた	%ANAME(MASTER)%回答了提问的肯定后，向作为君主的%ANAME(TARGET)%传达了自己的问候
「わざわざ挨拶に？　ふむ、それは感心だ」	「特意来问候？嗯，那可有心了」
「…この幻想郷は色々と自由奔放な人物が多いからな。ちゃんと礼節をもって挨拶に来てくれるのは嬉しいよ」	「…因为这个幻想乡有很多自由奔放的人物。你能有礼貌地来问候我，我很高兴」
そう言うと%ANAME(TARGET)%は柔和な眼差しで微笑んだ	这么说着，%ANAME(TARGET)%带着温柔的眼神微笑着
男を虜にするような美女の笑みを向けられ、%ANAME(MASTER)%はその美貌に心臓を打たれたような錯覚を抱いた	面对着能俘获男人的美女的笑容，%ANAME(MASTER)%有着为她的美貌动心的感觉
「それでは、これからよろしく頼むぞ。どうか私のために尽力してくれ。……ああ、それと」	「那么，今后请多关照。请为我而效力。……啊，还有」
%ANAME(TARGET)%は思い出したかのように一言付け加える	%ANAME(TARGET)%像想起来似地加上一句话
「今度挨拶に来る時は油揚げを持ってきてくれると、その、何だ…とても嬉しいぞ？」	「下次来打招呼的时候带上油炸豆腐，嗯？为什么？…因为我会很开心哦？」
「…まぁ、そういう目線には慣れております。それで、私に何か御用ですか？」	「…嘛，我已经习惯了这种视线。那么，有什么事要我做吗？」
誤魔化しの咳払いの後%ANAME(MASTER)%は、同盟国の方々に挨拶に参った、と伝えた	心虚地咳嗽后%ANAME(MASTER)%告诉同盟国的各位，我是来问候的
「ほう、挨拶に。わざわざご丁寧にどうも」	「是这样啊，谢谢您专程前来问候」
「私は%NAME_FORMAL(TARGET)%と申します。以後お見知りおきを」	「我名为%NAME_FORMAL(TARGET)%。以后请多关照」
「この先何があるか分かりませんが、少なくとも今は同士。共に力を合わせていきましょう」	「虽然不知道以后会发生什么，至少现在是伙伴。一起合力前进吧」
誤魔化しの咳払いの後%ANAME(MASTER)%は、この乱世を鎮めるために力を貸して欲しい、と伝えた	假装咳嗽后%ANAME(MASTER)%告诉她，为了平定这个乱世，希望你能助我一臂之力
「……ふむ、そういうことですか」	「嗯……是这样吗」
「私も幻想郷のために尽力する身、一先ずはよろしくお願いします」	「为了幻想乡也要尽力而为了，那么请多关照」
これは心強い！　名高い九尾の狐の力を借りれるとなると鬼に金棒だ	这真是好极了！有了九尾的帮助，真是如虎添翼
「あ、いや…私は厳密に言えば九尾の狐ではなくて、それを依代にしている式神なのだが…、まぁいいか」	「啊，不，不是…严格说来，我并不是九尾，而是以此为凭依的式神…算了吧」
「それでは、不肖この%NAME_FORMAL(TARGET)%、微力ながらお手伝いしましょう」	「那么，鄙人%NAME_FORMAL(TARGET)%，虽力微，但让我相助吧」
「…やあ、%ANAME(MASTER)%」	「…啊，%ANAME(MASTER)%」
捕虜用にあてがわれた部屋にて、九本の大きな尻尾を持った美女が%ANAME(MASTER)%の呼びかけに応えた	在被俘用的房间里，有九条大尾巴的美女回应了%ANAME(MASTER)%的召唤
%ANAME(MASTER)%は相変わらずの美貌にしばし見とれる	%ANAME(MASTER)%对着她那一如既往的美貌，一时看得出神
「ふう、相変わらずだな%ANAME(MASTER)%は。それで、私に何の用かな？」	「呵呵，还是老样子啊%ANAME(MASTER)%。那你找我有什么事吗？」
誤魔化しの照れ笑いの後%ANAME(MASTER)%は、この乱世を鎮めるため我が軍に力を貸して欲しい、と伝えた	为缓解尴尬地羞笑后%ANAME(MASTER)%说道，为了平定这个乱世，希望能借助其力量
「……ふむ。私を牢に繋がずにいた理由はそれか」	「……嗯。这就是你为什么不把我关在监狱里的原因吗」
「うーん、どうしようかな。お前のためならそれもやぶさかではないが……」	「嗯，怎么办呢。如果是为了你的话，那也不是很不乐意……」
「まあ、お前のことは嫌いではないが……。それとこれは話が違うしなぁ…」	「嘛，虽然我并不讨厌你……但也不能和这事相提并论啊…」
「…やはり、そう簡単に答えを出すわけにもいかない。すまないがもう少し時間をくれないだろうか」	「…还是不能那么草率地给出答案。对不起，能再给我点时间吗」
……流石に易々とは行かないようだ	……看来还是不容易地说服
だが感触は悪くない。このまま根気強く交流を続けて心変わりを願おう	但感觉还不错。就这样耐心地继续交流，希望其能改变心意吧
「それじゃあしばらく厄介になる。よろしく頼むよ、%ANAME(MASTER)%」	「那么暂时就麻烦多多关照了，%ANAME(MASTER)%」
「…まぁ、そういう目線には慣れているよ。それで、私に何か用ですか？」	「…嘛，我已经习惯了这种视线。那你找我有什么事吗？」
「ああ、%ANAME(MASTER)%。久しぶりだな」	「啊，%ANAME(MASTER)%。好久不见了」
九本の大きな尻尾を持った美女が%ANAME(MASTER)%の呼びかけに応えて振り向いた	有九根大尾巴的美女因%ANAME(MASTER)%的呼唤而转身
「ふふ、相変わらずだな%ANAME(MASTER)%は。それで、私に何か用かい？」	「呵呵，还是老样子呢%ANAME(MASTER)%桑。那你找我有什么事吗？」
誤魔化しの照れ笑いの後%ANAME(MASTER)%は、改めて%ANAME(TARGET)%様に挨拶に伺いました、と伝えた	尴尬地微笑后%ANAME(MASTER)%再次向%ANAME(TARGET)%大人打招呼
「ふむ、感心だぞ%ANAME(MASTER)%。やはり挨拶はちゃんとしないとな」	「嗯，感觉不错呢%ANAME(MASTER)%桑。果然还是要好好问候呢」
そう言うと%ANAME(TARGET)%は笑顔を浮かべ、%ANAME(MASTER)%の頭をよしよしと撫でた	这样说着，%ANAME(TARGET)%脸上浮现出笑容，温柔地抚摸着%ANAME(MASTER)%的头
突然の、しかし優しい手つきに逆らえず%ANAME(MASTER)%はなすがままになってしまった	突然的，但却无法违抗温柔的手法，%ANAME(MASTER)%就这样任其所为
「あっ…す、すまない。ついいつものクセで…。気分を害したりしていないか？　何だが顔が赤いようだが…」	「啊…对，对不起。不知不觉就习惯了…。你有没有心情不好？总觉得脸好像红了…」
紅潮した顔を何でもありませんと誤魔化すと、お互いの間に妙な空気が流れた…	当她用一张红潮的脸敷衍说没什么，两人之间便产生了奇妙的气氛…
「こほんっ、あー、それでは改めて。これからもよろしく頼むぞ、%ANAME(MASTER)%」	「真是的...啊，那么重新来过。今后也请多关照了，%ANAME(MASTER)%」
「…まぁ慣れてはいるが、目上の者にそういう視線を送るのは感心しないな。それで、私に何か用か？」	「…嘛，虽然已经习惯了，但是对上司用那样的眼光看，真让人佩服啊。那你找我有什么事吗？」
誤魔化しの咳払いの後%ANAME(MASTER)%は、この乱世を鎮めるため尽力します、と伝えた	为缓解尴尬地咳嗽后%ANAME(MASTER)%说道，会为了平定这个乱世而尽力
「ふむ、私も期待しているよ」	「嗯，我也期待着哦」
「それでは%ANAME(MASTER)%。改めて、よろしく頼む」	「那么%ANAME(MASTER)%。再一次地，请多关照」
誤魔化しの照れ笑いの後%ANAME(MASTER)%は、せっかく同盟を組んだのだから手土産を持って会いに来た、と伝えた	为缓解尴尬地害羞笑后%ANAME(MASTER)%告诉她，好不容易结成同盟，所以带着礼物来见她
「ほほう、わざわざ顔を出してくれるとは嬉しいよ」	「呵呵，你特地来见我，我很高兴」
「…それにその包み。油揚げだな？　匂いで分かるぞ。私のために用意してくれたのか？」	「…而且那个包。是油炸食品吧？闻着味道就知道了。特的为我准备的吗？」
%ANAME(TARGET)%は油揚げが好物と聞き持参した物だが、当人は大いに喜んでくれたようだ	你说听闻她喜欢吃油炸豆腐就拿来了，%ANAME(TARGET)%似乎非常高兴
「ふふ♪　%ANAME(MASTER)%は気が利くな。とても嬉しいよ」	「fufu♪%ANAME(MASTER)%很机灵呐。我很开心哦」
「私の方もお茶を出そう。どうかゆっくりしていってくれ」	「我来泡茶吧，请慢慢来」
誤魔化しの咳払いの後%ANAME(MASTER)%は、せっかく同盟を組んだのだから挨拶に来た、と伝えた	假装咳嗽后%ANAME(MASTER)%告诉她，好不容易结成同盟，所以特意来问候
「ほう、わざわざ挨拶に。それはご丁寧にどうも」	「啊，特意来打招呼。那太客气了」
「何があるわけでもありませんが、どうぞゆっくりしていってください」	「请不要客气，慢慢来就好」
誤魔化しの照れ笑いの後%ANAME(MASTER)%は、この乱世を鎮めるために力を貸して欲しい、と伝えた	缓解尴尬地害羞笑后%ANAME(MASTER)%告诉她，为了平定这个乱世，希望能借助你的力量
「……ふむ、そういうことか」	「……嗯，是这样啊」
「分かった。不肖この%NAME_FORMAL(TARGET)%、幻想郷の平和のために手を貸そう」	「明白了。鄙人%NAME_FORMAL(TARGET)%，为了幻想乡的和平也要尽力而为了」
「あ、その…私は厳密に言えば九尾の狐ではなくて、それを依代にしている式神なのだが…、あー、まぁいいか」	「啊，那个…严格说来，我并不是九尾，而是以此为凭依的式神…啊，算了吧」
「それでは、これからよろしく頼むぞ、%ANAME(MASTER)%」	「那么，接下来就拜托你了，%ANAME(MASTER)%」
「私も幻想郷のために尽力する身、微力ながら出来ることもあるでしょう」	「为了幻想乡我虽然力微但也要尽力而为之」
「それでは、不肖この%NAME_FORMAL(TARGET)%、お手伝い致しましょう」	「那么，鄙人%NAME_FORMAL(TARGET)%，来相助与你」
「ちゅ……おはよう、%ANAME(MASTER)%♥　良く眠れたか？」	「唔……早上好，%ANAME(MASTER)%♥睡得好吗？」
頬に口づけを受けて%ANAME(MASTER)%が目を覚ますと、添い寝していた%ANAME(TARGET)%の美貌が真っ先に目に入る	脸颊被亲吻后，%ANAME(MASTER)%醒了，陪睡的%ANAME(TARGET)%的美貌最先映入眼帘
部屋に差し入る朝日が金の髪を輝かせ、眩いばかりの美しさとなって%ANAME(MASTER)%の目を奪う	阳光照进房间里，金发闪闪发光，美得令人目眩，吸引了%ANAME(MASTER)%的目光
「ふふ、私に見惚れてくれるのか？　ならもっと、近くへおいで♥」	「fufu，迷上我了吗？那就再靠近一点吧♥」
%ANAME(TARGET)%は%ANAME(MASTER)%を抱き寄せ、鼻が触れ合いそうな距離まで近づけた	%ANAME(TARGET)%把%ANAME(MASTER)%抱过来，接近到可以相触鼻子的距离
「これなら、私の愛しい旦那様の顔もよく見えるな♥」	「这样的话，我亲爱的脸也能看得清清楚楚呢♥」
二人はしばし抱き合いながらイチャイチャした……	两个人拥抱在一起亲热了一阵……
「ああ、幸せだよ%ANAME(MASTER)%♥」	「啊啊，好幸福啊♥」
「この幸せを守るためなら、私はなんだってするからな…」	「为了守护这份幸福，我什么都会做…」
「…%ANAME(MASTER)%……私の愛しい人…♥」	「…%ANAME(MASTER)%……我的爱人…♥」
朝、やたら心地良い感触と香りに目が覚めると、%ANAME(TARGET)%が膝枕してくれていた	早上，被舒畅的触感和香味吵醒的时候，发现正枕在%ANAME(TARGET)%的膝盖上
さらには布団が剥ぎ取られ、代わりに九本の尻尾が布団代わりに%ANAME(MASTER)%の身体を包んでいた	更甚的是被子被剥掉了，取而代之的是九条尾巴代替被子包裹着%ANAME(MASTER)%的身体
「ふふ…おはよう%ANAME(MASTER)%…♥」	「呵呵…早上好，%ANAME(MASTER)%…♥」
返事を返したいところだが、九尾布団の極上の気持ち良さに夢心地となり、再び意識が夢にいざなわれる…	虽然很想回复，但是九尾被褥的极舒适感让人如梦一般，意识再次被梦乡所迷醉…
「私の尻尾布団、気持ち良いでしょう？　そこらの布団とはモノが違うぞ…♥」	「我的尾巴被子很舒服吧？和那些被子氪不一样呢…♥」
囁くような声とふわふわモフモフで暖かい尻尾に包まれ、%ANAME(MASTER)%の意識は夢の世界に旅立った…	轻声细语般的声音和轻飘飘的柔软尾巴包围着%ANAME(MASTER)%的意识出发去了梦的世界…
「あぁ、涎垂らしちゃって…。ちゅ…、そんなに気持ちいいんだな、嬉しい…♥」	「啊，流口水了…。fufu…真的那么舒服吗…感觉很开心呢…♥」
（……妾でも私は幸せだよ。…愛する%ANAME(MASTER)%と、こうして一緒にいられるのなら…♥）	（……即使是妾，我也很幸福。…如果能和爱着的%ANAME(MASTER)%这样在一起的话…♥）
…結局%ANAME(MASTER)%は、昼過ぎまで%ANAME(TARGET)%にたっぷり甘やかされてから今日の活動を開始した	…结果%ANAME(MASTER)%在过了中午之前被%ANAME(TARGET)%充分宠爱之后开始了今天的工作
「……私は紫様に、心から感謝しているよ」	「……我从心底里感谢紫大人」
%ANAME(TARGET)%は愛おしい目で%ANAME(MASTER)%を眺めながら語る	%ANAME(TARGET)%用爱恋的眼睛看着%ANAME(MASTER)%说道
「私は主のプログラム通りに動く式だ。本来、命令以外のことなどしない様にも出来たはずなんだ」	「我是服务于主人的式神。本来，除了命令以外的事情也应该不做的」
「それでも紫様は、私に自由な意思をくれた。誰かを愛し、それに応える心を与えてくれた」	「尽管如此，紫大人还是给了我自由的意志。能爱着谁，给予了我回应的【心】」
「だから%ANAME(MASTER)%とこうしていられる…。本当に感謝してもしきれない」	「所以能这样和%ANAME(MASTER)%在一起…。真是感激不尽」
%ANAME(TARGET)%は%ANAME(MASTER)%の腕を抱いて寄り添っている。その目はうっすら潤んでいるように見えた	%ANAME(TARGET)%抱着%ANAME(MASTER)%的手臂依偎在一起。那双眼睛看上去有些湿润
そんな彼女の頭を%ANAME(MASTER)%は優しく撫でた	%ANAME(MASTER)%温柔地抚摸着她的头
「…ありがとう、%ANAME(MASTER)%♥」	「…谢谢你，%ANAME(MASTER)%♥」
「ああ。いらっしゃい、%ANAME(MASTER)%」	「啊。欢迎，%ANAME(MASTER)%」
%ANAME(TARGET)%を訪ねると、彼女は%ANAME(MASTER)%の腕を取って抱きついてきた	去拜访%ANAME(TARGET)%时，她拿起%ANAME(MASTER)%的手腕紧紧地抱住了
「ふふ、いいじゃないか、これぐらい。もっと大胆なことをした仲だろう？　私たちは♥」	「fufu，这样不是挺好的吗？我们是做了更大胆的事了吧，不是么♥」
%ANAME(MASTER)%の耳元で色っぽく囁く彼女の顔には愉悦の色が浮かんでいた	在%ANAME(MASTER)%的耳边轻声细语着的她的脸上浮现出喜悦的色彩
待ち合わせ場所に既に%ANAME(TARGET)%が待っていた。心なしか顔が赤いような…	%ANAME(TARGET)%已经在约定的地方等待着。可能是心理作用吧，感觉脸都红了…
「私が身体を許すなんて、滅多にない事なんだぞ？」	「我以身相许，这种事是很难得的哦？」
「だからちゃんと責任、取っておくれよ」	「所以好好负起责任吧」
「あ…おはよう%ANAME(MASTER)%。会いたかったぞ♥」	「啊…早上好，%ANAME(MASTER)%。真想见你啊♥」
%ANAME(TARGET)%は%ANAME(MASTER)%を見つけると、笑顔で出迎えてくれた	%ANAME(TARGET)%发现%ANAME(MASTER)%时，笑着迎接了我
「おはよう%ANAME(MASTER)%。今日はいい天気だな」	「早上好%ANAME(MASTER)%。今天天气真好啊」
先日キスを交わしたはずだったが、%ANAME(TARGET)%は今までとあまり変わらない様子だ	我们前几天明明接吻过的，%ANAME(TARGET)%却和以前没什么变化的样子
「口付けくらい、そう騒ぐほどのことではないだろう？」	「只是一个吻，不至于那么吵闹吧？」
「……まぁ、誰にでも許すわけではないけどな」	「……嘛，虽然并不是谁都可以的」
（…私が思っていた以上に誠実な人なんだな……素敵だ…）	（…是一个比我想象中还要诚实的人啊……太棒了…）
%ANAME(TARGET)%は少し頬を染めながら%ANAME(MASTER)%のことをぽーっと見ている	%ANAME(TARGET)%的稍微染上了绯红了，看向了%ANAME(MASTER)%
「…%ANAME(MASTER)%……私の可愛い旦那様…♥」	「…%ANAME(MASTER)%……我心爱的丈夫…♥」
「私の尻尾布団、良いだろう？　そこらの布団とはモノが違うぞ…♥」	「我的尾巴被子舒服吗？和那边被子不一样哦…♥」
「あぁ、涎垂らしちゃって…。ちゅ…、そんなに気持ちいいんだな、嬉しいぞ…♥」	「啊，都流口水了…。咦…真的是那么舒服啊，好开心啊…♥」
「もうちょっと寝ていてもいいぞ。私がちゃんと見守っててあげるからな、%ANAME(MASTER)%…♥」	「可以再睡一会儿哦，%ANAME(MASTER)%。我会好好守护你的…♥」
「%ANAME(MASTER)%、おはよう。…ふふっ、私の旦那様は今日も素敵だな♥」	「%ANAME(MASTER)%、早上好。…fufu，我的丈夫今天也很帅啊♥」
%ANAME(TARGET)%は待ち合わせに現れた%ANAME(MASTER)%の顔を間近で見ながら蕩けた顔で微笑みかける	%ANAME(TARGET)%在约会时紧盯着%ANAME(MASTER)%的脸，沉醉于其中地微笑着
「あんまり素敵なもので、押し倒しそうになってしまったよ♥　ココが自宅じゃなくてよかったな」	「啊啦，差点就要推倒了♥差点忘了这可不在家里呢」
……むしろ残念なような気も……	……反而感觉很遗憾……
%ANAME(MASTER)%は待ち合わせ場所で待つ%ANAME(TARGET)%にちょっとした悪戯をすることにした	%ANAME(MASTER)%决定对在约会地点等待的%ANAME(TARGET)%稍微恶作剧一下
彼女の後ろからこっそり近づいて驚かそうとしたが近づいた途端、九本の尻尾に体を絡め取られてしまった	悄悄地从她后面靠近，想吓她一跳，但一靠近，身体就被九根尾巴缠住了
「ふっふっふっ、私が愛しい旦那様の気配に気付かないわけがないだろう？　%ANAME(MASTER)%♥」	「fufufu，我怎么可能不注意到心爱的夫君的行迹呢？%ANAME(MASTER)%♥」
%ANAME(MASTER)%はふわふわモフモフの尻尾に揉みくちゃにされて恍惚としてしまった	%ANAME(MASTER)%被软绵绵的尾巴抚摸得神情恍惚
「おはよう、旦那様♥　…ふふっ、朝からちょっと舞い上がってしまったな」	「早上好，夫君♥　…fufu，从早上开始就很期待了呢」
%ANAME(TARGET)%は待ち合わせに現れた%ANAME(MASTER)%に微笑みかけながら、お弁当を手渡してきた	%ANAME(TARGET)%一边微笑着面对来约会的%ANAME(MASTER)%，一边递出了便当
「もし朝ごはんを食べてなかったら、これでも食べてくれ。もう食べてたらお昼ご飯にしてくれてもいいぞ」	「如果你没吃早饭的话，就吃这个吧。已经吃了的话可以给当做午饭哦」
…慌てて朝飯を抜いて来たから、とても助かります…	…因为匆匆忙忙忙地而没吃早饭，真是帮了我大忙了…
「ああ、おはよう、%ANAME(MASTER)%……。うん、元気が出たよ」	「啊，早上好，%ANAME(MASTER)%……。嗯，打起精神来了」
%ANAME(TARGET)%は最初なにやら不安そうな顔だったが、%ANAME(MASTER)%の姿を見ると表情が明るくなった	%ANAME(TARGET)%最初是一副不安的表情，但是一看到%ANAME(MASTER)%表情就变得明朗起来了
「どうしたって？　いや、その…昨日、ちょっと怖い夢を見て…%ANAME(MASTER)%が無事で良かった…」	「怎么了？不，那个…昨天做了个有点恐怖的梦…%ANAME(MASTER)%平安无事真是太好了…」
%ANAME(TARGET)%は%ANAME(MASTER)%の腕を抱くように寄り添ってきた。仄かに頬が染まっていた	%ANAME(TARGET)%抱着%ANAME(MASTER)%的手臂靠了过来，脸上染上了绯红
「ふふ♪　今日も良く来てくれたな。嬉しいよ%ANAME(MASTER)%♥」	「fufu♪今天你也来了呢。我很高兴哦♥」
「今日一日、%ANAME(MASTER)%の時間を私におくれ。愛しい旦那様と過ごす時間が、私にとってとても幸せな時間なんだ…♥」	「今天一天，把%ANAME(MASTER)%的时间交给我。和心爱的夫君一起度过的时间，对我来说是非常幸福的时间…♥」
「おはよう、%ANAME(MASTER)%。…ふふっ、もう%ANAME(MASTER)%の顔を見ないと駄目な身体になってしまったよ」	「早上好，%ANAME(MASTER)%。…fufu，已经变成了看不到%ANAME(MASTER)%的脸就不行的身体了呢」
「だから責任を取って、私の瞳に旦那様の素敵な顔を焼き付けておくれ？　…くすっ、ああもう可愛いなぁ%ANAME(MASTER)%は♥」	「所以，请你负起责任，在我的眼睛里印上夫君那张漂亮的脸吧？　…啊，真可爱啊%ANAME(MASTER)%♥」
%ANAME(TARGET)%は幸せそうに頬を緩ませながら%ANAME(MASTER)%に微笑みかけてきた	%ANAME(TARGET)%幸福地放松着脸颊，对%ANAME(MASTER)%微笑着
「ああ、%ANAME(MASTER)%、おはよう♥　今日も気持ちいい天気だな」	「啊，%ANAME(MASTER)%，早上好♥今天天气也很好啊」
%ANAME(TARGET)%は慈しむような表情で%ANAME(MASTER)%に微笑みかけた	%ANAME(TARGET)%带着慈祥的表情对%ANAME(MASTER)%微笑着
「あ、今出るところか？　おはよう、%ANAME(MASTER)%♥」	「啊，现在正要出去吗？早上好，%ANAME(MASTER)%♥」
%ANAME(TARGET)%との待ち合わせに向かうところだったが、部屋を出たとたん%ANAME(TARGET)%と鉢合わせた	正要和%ANAME(TARGET)%约会的时候，一出房间就碰上了%ANAME(TARGET)%
「今日はちょっと早く起きてしまってな。無性に%ANAME(MASTER)%の顔が見たくなって、つい来てしまったよ…」	「今天起得有点早呢。因为非常想看到%ANAME(MASTER)%的脸，所以不知不觉就来了…」
口元を袖で隠しながら、少し恥ずかしそうに言う%ANAME(TARGET)%。後ろでは九本の尻尾が嬉しそうに揺れている	%ANAME(TARGET)%一边用袖子遮住嘴角，一边害羞地说。后面九根尾巴高兴地摇着
そのいじらしい様に自然と笑みがこぼれる。待たせるのも悪いからすぐに行こう	看着她那可爱的样子自然地露出了笑容。让她等着也不好，马上出发吧
「ふふっ♪ありがとう。急かすようで悪いが、とても嬉しいよ」	「呵呵♪谢谢。虽然像催促你似地感觉不好意思，但是我很开心」
「さあ、今日は何をしたい？　何でも言ってくれていいぞ%ANAME(MASTER)%♥」	「那么，今天想做什么？什么都可以说哦%ANAME(MASTER)%♥」
トントントン……	吨吨吨……
かすかに響く包丁の音と、鼻腔をくすぐる良い匂いで%ANAME(MASTER)%は目が覚めた	因为微弱回响的菜刀的声音和能勾起鼻腔的香味，%ANAME(MASTER)%醒来了
「あ、起きたか？　おはよう、%ANAME(MASTER)%♥」	「啊，起来了吗？早上好，%ANAME(MASTER)%♥」
いつの間にか、%ANAME(TARGET)%が上がりこんで朝食を用意してくれていた	不知什么时候，%ANAME(TARGET)%已经进来给我准备了早餐
「ちゃんと朝ごはんを食べて、元気に一日を始めようか」	「好好吃早饭，精神饱满地开始一天吧」
「おはよう%ANAME(MASTER)%♥　来てくれありがとう、とても嬉しいよ♥」	「早上好%ANAME(MASTER)%♥谢谢你能来，我很高兴哦♥」
%ANAME(TARGET)%はとびきり上機嫌な様子で%ANAME(MASTER)%を出迎えてくれた	%ANAME(TARGET)%高兴地迎接了%ANAME(MASTER)%
「ああ、%ANAME(MASTER)%。こっちだよーっ♪」	「啊，%ANAME(MASTER)%。在这边哦♪」
%ANAME(TARGET)%は%ANAME(MASTER)%を手と尻尾を勢い良く振って出迎えてくれた	%ANAME(TARGET)%用力挥着手和尾巴迎接了%ANAME(MASTER)%
「ふふ♪　今日は良く来てくれたな%ANAME(MASTER)%」	「呵呵♪今天你能来真是太好了」
「今日一日、私に付き合っておくれ。%ANAME(MASTER)%といる時間が、私にとってとても大事な時間なんだ…♥」	「今天一天，请陪着我。和%ANAME(MASTER)%在一起的时间，对我来说是非常重要的时间…♥」
「おはよう、%ANAME(MASTER)%。…ふふっ、最近は%ANAME(MASTER)%の顔を見ないと調子が出ないようになってしまったよ」	「早上好，%ANAME(MASTER)%。…呵呵，最近不看%ANAME(MASTER)%的脸的话就提不起劲了呢」
「だから責任を取って、私の瞳にお前の顔を焼き付けておくれ？　…くすっ、困った顔も可愛いな%ANAME(MASTER)%は♥」	「所以请负起责任，把你的脸印在我的眼睛里？　…呃，困惑的表情也很可爱哦，%ANAME(MASTER)%♥」
%ANAME(TARGET)%は悪戯っぽく%ANAME(MASTER)%に微笑みかけてきた	%ANAME(TARGET)%恶作剧般地向%ANAME(MASTER)%微笑着
「ああ、起こしてしまったか？　すまないな」	「啊，把你吵醒了吗?对不起啊」
いつの間にか部屋に%ANAME(TARGET)%が上がりこんでおり、朝食を用意してくれていた	不知什么时候%ANAME(TARGET)%进了房间里，为我准备了早餐
「私に会いに来てくれたのか？　ふふっありがとう、嬉しいよ♥」	「你来看我了吗?fufu，谢谢你，我很高兴♥」
%ANAME(TARGET)%は嬉しそうに%ANAME(MASTER)%に寄り添ってきた	%ANAME(TARGET)%很高兴地靠近了%ANAME(MASTER)%
%ANAME(TARGET)%との待ち合わせ場所で待っていると、背後から毛のようなものでくすぐられた	在和%ANAME(TARGET)%约会的地方等着的时候，从背后被毛一样的东西弄得痒痒的
%ANAME(MASTER)%が変な声を上げて振り向くと、尻尾でくすぐってきた%ANAME(TARGET)%の姿があった	%ANAME(MASTER)%发出奇怪的声音回头一看，看到了用尾巴挠起痒痒来的%ANAME(TARGET)%的身影
「ふふっ、すまない%ANAME(MASTER)%♥　ちょっとからかってみたくなって」	「呵呵，对不起%ANAME(MASTER)%♥ 我想稍微捉弄你下」
%ANAME(MASTER)%は、悪戯で屈託無く笑う%ANAME(TARGET)%の笑顔にドキっとした	%ANAME(MASTER)%被恶作剧中毫不做作地笑着的%ANAME(TARGET)%的笑容所打动
「ふふ、おはよう%ANAME(MASTER)%。来てくれてありがとう、会いたかったぞ♥」	「呵呵，早上好%ANAME(MASTER)%。谢谢你能来，我正想见你♥」
%ANAME(TARGET)%は%ANAME(MASTER)%を見つけると、頬を染めながら笑顔で出迎えてくれた	%ANAME(TARGET)%看到了%ANAME(MASTER)%，脸上泛着笑容迎接了我
「ああ、%ANAME(MASTER)%。こっちだぞーっ」	「啊，%ANAME(MASTER)%。在这边哦」
%ANAME(TARGET)%は%ANAME(MASTER)%を手を振って出迎えてくれた	%ANAME(TARGET)%挥手迎接了%ANAME(MASTER)%
「ふふ♪　良く来てくれたな%ANAME(MASTER)%」	「fufu♪ 可算来了啊%ANAME(MASTER)%」
「悪いが今日一日付き合っておくれ。%ANAME(MASTER)%といると楽しい気分になるんだ」	「不好意思，请陪我今天一天。和%ANAME(MASTER)%在一起的时候心情会很愉快。」
「やあ、%ANAME(MASTER)%」	「呀，%ANAME(MASTER)%」
「…言っておくが、身体は許しても心まで許したわけではないからな」	「……我先声明，虽然你得到了我的身体，但并没有得到我的心。」
心なしか、ほんのり顔が赤いような……	也许是心理作用吧，脸稍微红了点……
「あ…おはよう%ANAME(MASTER)%。会いたかったぞ」	「啊…早上好%ANAME(MASTER)%。真想见你啊」
「おはよう%ANAME(MASTER)%。今日は買い物に付き合ってもらいたいんだが」	「早上好%ANAME(MASTER)%。今天想请你陪我去买东西」
「あ、おはよう%ANAME(MASTER)%。出かけるにはいい天気だな」	「啊，早上好%ANAME(MASTER)%。今天是个出门的好天气啊」
「おはよう%ANAME(MASTER)%。では今日も行こうか」	「早上好%ANAME(MASTER)%。那么今天也出去吧」
「やあ、%ANAME(MASTER)%。待っていたよ♥」	「啊啦，%ANAME(MASTER)%。我一直在等着你♥」
%ANAME(TARGET)%はなにやら上機嫌だ。心なしか、ほんのり顔が赤いような……	%ANAME(TARGET)%总觉得心情很好。也许是心理作用吧，脸有点红……
「やあ、%ANAME(MASTER)%。今日もいい天気だな」	「啊啦，%ANAME(MASTER)%。今天天气真好啊」
「やあ、%ANAME(MASTER)%。今日は買出しに付き合ってくれないか？」	「啊啦，%ANAME(MASTER)%。今天能陪我去买东西吗？」
「おはよう、%ANAME(MASTER)%。今日は何をするんだい？」	「早上好，%ANAME(MASTER)%。今天做什么？」
「やあ、%ANAME(MASTER)%殿。本日はどのような用件で？」	「啊，%ANAME(MASTER)%阁下。今天有什么事？」
「…なぁ、%ANAME(MASTER)%」	「…呐，%ANAME(MASTER)%」
初めて身体を重ねた後、%ANAME(TARGET)%は%ANAME(MASTER)%の手を両手で包むように手に取って話す	第一次身体重叠后，%ANAME(TARGET)%用双手握住%ANAME(MASTER)%的手说道
「ここまでしたからには…私のこと、一生大切にしておくれ…♥」	「既然做到了这一步…请一生珍惜我…♥」
その後二人は、互いに抱き合うようにして眠りについた	之后两个人相拥而眠了
（私が身体まで許すとは、な……）	（我竟然连身体都允许了，真是的……）
「橙に示しがつかないな、こんなザマでは…」	「不能作为橙的榜样了，这样的话…」
「%ANAME(MASTER)%、ちょっと」	「%ANAME(MASTER)%，唔....」
%ANAME(TARGET)%に呼ばれて%ANAME(MASTER)%が振り返ると、キスで唇をふさがれた	%ANAME(MASTER)%被%ANAME(TARGET)%所唤，回头一看，被堵住了嘴唇
「ん……。お別れのキスだよ、気をつけて帰るんだぞ♥」	「嗯……。离别之吻啊，回去的时候要小心哦♥」
突然のキスと妖艶な微笑みに、%ANAME(MASTER)%はドキドキしている…	突然的吻和妖艳的微笑，让%ANAME(MASTER)%怦然心动…
%ANAME(TARGET)%は%ANAME(MASTER)%の肩に頭をのせた	%ANAME(TARGET)%把头放在%ANAME(MASTER)%的肩上
「…もう少しこのままでいさせてくれ…」	「…再让我待一会儿吧…」
「お前となら、もっと先まで…い、いや、何でもない！」	「和你在一起的话，再往前走一点也…不，不，没什么！」
%ANAME(TARGET)%は慌てて手を振り別れた。帰り際、少し顔が赤かったような…	%ANAME(TARGET)%慌张地挥手告别。回去的时候，脸有点红…
%ANAME(TARGET)%は唇に指を当て、少々呆けていたがすぐに平静を取り戻した	%ANAME(TARGET)%把手指贴在嘴唇上，有点呆了，但很快又恢复了平静
「ちゅ…♥　今日もお疲れ様、%ANAME(MASTER)%」	「唔…♥ 今天也辛苦了，%ANAME(MASTER)%」
%ANAME(TARGET)%に抱きしめられ、優しいキスで唇をふさがれた	被%ANAME(TARGET)%拥抱，用温柔的吻堵住了嘴唇
「ふふ、お休みのキス。そっちからもしてほしいな…♥」	「呵呵，是离别的吻哦。希望下次再从你那得到回吻啊…♥」
甘えるような仕草と妖艶な微笑みのコンボに、%ANAME(MASTER)%はキュンとしてしまった	撒娇似的动作和妖艳的微笑的组合，让%ANAME(MASTER)%怦然心动
「それじゃあ、また明日…かわいい私の旦那様♥」	「那么，明天见…我心爱的夫君♥」
「もうこんな時間なのか…じゃあ、%ANAME(MASTER)%。私は今日お前の部屋で一緒に寝ることにするよ」	「已经这个时间了吗…那么，%ANAME(MASTER)%。我决定今天在你的房间一起睡」
「ん？　何でわざわざって？　まったく、愛する旦那様を一人寂しく寝させるわけないだろう？」	「嗯？为什么特意？真是的，怎么可能让我心爱的夫君一个人寂寞地睡呢？」
%ANAME(TARGET)%は自慢の尻尾を%ANAME(MASTER)%に絡ませながら抱きついてきた	%ANAME(TARGET)%用自己引以为豪的尾巴缠着%ANAME(MASTER)%抱了过来
「…それに、そうすれば朝起きたとき、一番に%ANAME(MASTER)%の顔を見れるから…な♥」	「…而且，这样早上起来的时候，就能最先看到%ANAME(MASTER)%的脸了…♥」
「今日も一日お疲れ様、%ANAME(MASTER)%。もう遅いし、今日は私の部屋で寝ていくといい」	「今天一天也辛苦了，%ANAME(MASTER)%。已经很晚了，今天睡在我的房间里就好了」
%ANAME(TARGET)%はそう言うと、九本の尻尾を%ANAME(MASTER)%の全身に絡める。極上の感触が身体を包んでいく…	%ANAME(TARGET)%这样说着，九条尾巴缠在了%ANAME(MASTER)%的全身上。极上的触感包裹着身体…
「添い寝で抱きしめながら、この尻尾で包んであげる。きっと気持ちいいぞ…♥」	「抱着你用尾巴裹着陪睡哦，一定很舒服哦…♥」
%ANAME(TARGET)%の柔らかな身体とふわふわの尻尾に包まれて、%ANAME(MASTER)%は夢心地で眠りについた…	在%ANAME(TARGET)%柔软的身体和飘乎乎的尾巴的包围下，%ANAME(MASTER)%在梦幻中睡着了…
「%ANAME(MASTER)%…今日もお疲れ様。カッコ良かったぞ…♥」	「%ANAME(MASTER)%…今天也辛苦了。太帅啊…♥」
%ANAME(TARGET)%は%ANAME(MASTER)%の頭を抱きかかえながら優しく頭を撫でている	%ANAME(TARGET)%抱着%ANAME(MASTER)%的头温柔地抚摸着
まるで子供をあやす様だが、%ANAME(TARGET)%の甘い香りと愛情が込められた撫で方に自然と意識が緩む…	简直就像是哄孩子的样子，但是在%ANAME(TARGET)%的甜蜜香气和充满爱情的抚摸中，自然地放松了意识…
「はああぁ…♥♥　すごくよかったよ%ANAME(MASTER)%♥」	「啊啊啊啊…♥♥真是太好了%ANAME(MASTER)%桑♥」
%ANAME(TARGET)%は愛欲に蕩けきった表情で、瞳に♥を浮かべなが%ANAME(MASTER)%に寄り添っている	%ANAME(TARGET)%用沉醉于爱欲的表情，在瞳孔中♥浮现在脑海中的是%ANAME(MASTER)%
「愛しい旦那様とのセックス。すごくキモチよくて、とても幸せなんだ…♥　これからも、いっぱい私を抱いておくれ♥」	「和心爱的夫君做爱。非常开心，非常幸福…♥今后也请多多抱我♥」
「今日も一日お疲れ様、%ANAME(MASTER)%♥　もう遅いし、今夜はこのまま、一緒に眠ろうか」	「今天一天也辛苦了，%ANAME(MASTER)%♥已经很晚了，今晚就这样一起睡吧」
「%ANAME(MASTER)%…今日もお疲れ様。とってもキモチ良かったぞ…♥」	「%ANAME(MASTER)%…今天也辛苦了。感觉非常棒呢…♥」
「ん？　寝ちゃいそう？　良いぞ、このまま添い寝してあげるから。…お休み、愛しい愛しい旦那様…♥」	「嗯？要睡了吗？好啊，就这样陪你睡吧。…晚安，我亲爱的夫君…♥」
「それじゃあ、また明日…。私の愛しい人…♥」	「那么，明天见…。我的爱人…♥」
「もうこんな時間なのか…じゃあ、%ANAME(MASTER)%。今日はお前の部屋で一緒に寝させて欲しいんだが…」	「已经这个时间了吗…那么，%ANAME(MASTER)%。今天我想和你一起睡在一起…」
「ん？　何でわざわざって？　まったく…、妾とは言え、愛する人と一緒にいたいと思うのは自然だろう？」	「嗯？为什么特意？真是…虽说是妾，但想和所爱的人在一起是理所当然的吧？」
「ん？　寝ちゃいそう？　良いぞ、このまま添い寝してあげるから。お休み……私の、大好きな人…♥」	「嗯？要睡了吗？好啊，就这样陪你睡吧。晚安……我最喜欢的人…♥」
「%ANAME(MASTER)%とのセックス、すごく幸せでとてもキモチいいんだ…♥　正妻のついででもいいから、これからもいっぱい私を抱いておくれ♥」	「和%ANAME(MASTER)%一起做爱，非常幸福，感觉非常好…♥即使是和正妻一起也可以，今后也请多多抱我♥」
「今日も一日お疲れ様、%ANAME(MASTER)%。もう遅いし、今夜はこのまま、一緒に眠ろうか」	「今天一天也辛苦了，%ANAME(MASTER)%。已经很晚了，今晚就这样一起睡吧」
「また逢いに来ておくれ。…ちゅ……待ってるからな♥」	「下次再相见吧。…唔……我会等你的♥」
「ふふ、お別れのキスだよ。そっちからもしてほしいな…♥」	「呵呵，是离别之吻哦。希望下次再从你那得到回吻啊……♥」
可愛らしい要求と妖艶な微笑みのギャップに、%ANAME(MASTER)%はドキドキしている…	可爱的要求和妖艳的微笑之间的反差，让%ANAME(MASTER)%怦然心动…
「%ANAME(MASTER)%が望むなら、私は何でもしてあげるから…」	「如果是%ANAME(MASTER)%希望的话，我什么都会为你做…」
「何にも遠慮しなくてもいいんだぞ？　ふふ♥♥」	「不用客气哦？fufu♥♥」
%ANAME(TARGET)%は妖艶な笑みを%ANAME(MASTER)%に向けた	%ANAME(TARGET)%带着妖艳的笑容转向了%ANAME(MASTER)%
「%ANAME(MASTER)%、今日は泊まっていかないか？　なあ、いいだろう？」	「%ANAME(MASTER)%，今晚就住这吧？呐，可以吧？」
%ANAME(TARGET)%はそう言うとモフモフの尻尾で%ANAME(MASTER)%の全身を揉みくちゃにしてきた。極上の感触が身体を包む…	%ANAME(TARGET)%这样说着，用蓬松柔软的尾巴揉着%ANAME(MASTER)%的全身。极上的触感包裹着身体…
「泊まっていけば…この自慢の尻尾で色々楽しませてあげるぞ♥」	「如果住在这的话……用这个引以为豪的尾巴让你享受各种各样的乐趣哦~♥」
妖艶な微笑みと極上のモフモフ攻撃に屈し、%ANAME(MASTER)%はお泊りを決めた…	屈服于妖艳的微笑和赛高的尾巴攻击、%ANAME(MASTER)%决定留宿了…
「また抱いておくれ。…ちゅ……待ってるからな♥」	「请再紧抱点。…唔……我会等你的♥」
「ふふ、お休みのキスだよ。そっちからもしてほしいな…♥」	「fufu，离别之吻。希望下次再从你那得到回吻啊…♥」
「あぁ…♥　とてもよかったよ%ANAME(MASTER)%♥」	「啊…♥真是太好了%ANAME(MASTER)%♥」
「お前とセックスしていると、何だか幸せな気分になるんだ…これからも、いっぱい私を抱いておくれ♥」	「和你做爱的话，总觉得会变得幸福…今后也请多多抱我♥」
「%ANAME(MASTER)%、今夜は私と一緒の布団で眠らないか？　なあ、いいだろう？」	「%ANAME(MASTER)%、今晚就大被同眠吧？呐，可以吧？？」
「そうすれば…この自慢の尻尾で色々楽しませてあげるぞ♥」	「如果这样的话……用这个引以为豪的尾巴让你享受各种各样的乐趣哦~♥」
妖艶な微笑みと極上のモフモフ攻撃に屈し、%ANAME(MASTER)%は同衾を決めた…	屈服于妖艳的微笑和赛高的尾巴攻击、%ANAME(MASTER)%决定一起睡了了…
「また、逢いに来て…。……待ってるから」	「再来见我哦……我等着你」
%ANAME(TARGET)%は寂しそうな顔をしていたが、%ANAME(MASTER)%が次回の約束をすると笑顔を取り戻してくれた	虽然%ANAME(TARGET)%看起来很寂寞，但是在%ANAME(MASTER)%下次的约定下恢复了笑容
「楽しい時間はすぐ過ぎていってしまうな」	「幸福的时光转眼而逝」
「%ANAME(MASTER)%とはもっと一緒に居たいのに…、ままならないなぁ」	「明明想和%ANAME(MASTER)%一直在一起呢…真是不如意啊…」
「今生の別れでもないのに…、何でこんなに名残惜しいんだろうな…」	「明明不是生离死别……为什么这么恋恋不舍呢…」
%ANAME(TARGET)%は%ANAME(MASTER)%の袖を掴んでいたが、すぐに離して寂しそうな笑顔で別れた	%ANAME(TARGET)%抓住了%ANAME(MASTER)%的袖子，但是马上带着寂落的笑容分开了
「また、抱いてくれ。……待ってるから」	「下次相见时再抱紧我哦……我等着你」
「はぁ…♥　よかったよ%ANAME(MASTER)%。…でも、もう時間なんだな」	「哈…♥ 沉迷了呢%ANAME(MASTER)%。…但是，已经到时间了」
「普段は寂しい思いをするところだが…今日は一緒に寝れるから寂しくないよ…♥」	「虽然平时有点寂寞…今天能一起睡所以不寂寞…♥」
「…もう時間か？　この夜が終わるのが名残惜しいな…」	「…时间到了吗？这个夜的结束真令人恋恋不舍…」
「%ANAME(MASTER)%、今度もまた抱いておくれ。今日よりずっと長く、激しく…な♥」	「下次也请再拥抱我。比今天更长，更激烈…哈呜♥」
「お疲れ様、後はゆっくりするとしようか」	「辛苦了，之后好好休息吧」
「ふふ♪　……あ、もうこんな時間か」	「fufu♪……啊，已经这个时间了」
「%ANAME(MASTER)%といると、時間が早く過ぎていく気がするよ」	「和%ANAME(MASTER)%在一起的话，感觉时间过得很快」
「だんだん%ANAME(MASTER)%のことが分かってきた気がするよ」	「我觉得我渐渐明白了%ANAME(MASTER)%的事情」
「意外な一面もあるものだな。ふふふ」	「也有意外的一面呢。fufufu」
「今日もお疲れ様。気をつけて帰るんだぞ」	「今天也辛苦了。回去的时候要小心啊」
%ANAME(TARGET)%は微笑みながら手を振り、%ANAME(MASTER)%を見送った	%ANAME(TARGET)%微笑着挥手，目送着%ANAME(MASTER)%
%ANAME(TARGET)%から、なにやら熱っぽい視線を送られている	%ANAME(TARGET)%投来了热情的目光相送
「それじゃあ、これで」	「那就这样吧」
「愛する旦那様のためならどこへでも♥」	「为了所爱的夫君，无论去哪里都可以♥」
「ふふっ♥　たまには妾も可愛がっておくれ♥」	「fufu♥ 偶尔也宠爱一下妾身吧♥」
「愛する%ANAME(MASTER)%のためならどこへでも♥」	「为了所爱的%ANAME(MASTER)%无论到哪里都行♥」
「ふふ、お呼びかな♥」	「fufu，在叫我是吧♥」
「お呼びでしょうか」	「您在叫我吧」
「お呼びですか？」	「您叫我吗？」
「ハァ、ハァ…すまない…、む、夢中になりすぎた…」	「哈，哈…对不起…嗯，太入迷了…」
「愛しい旦那様とのセックス。とても幸せで、すごくキモチいいんだ…♥　これからも、いっぱい私を抱いておくれ♥」	「和心爱的夫君做爱。非常幸福，非常舒服哦…♥ 今后也请多多抱我♥」
「%ANAME(MASTER)%、今夜は泊まっていかないか？　なあ、いいだろう？」	「%ANAME(MASTER)%，今晚要不要留宿？呐，好吧？」
「%ANAME(MASTER)%とはもっと一緒に居たいのに…、ままならないなぁ…」	「明明想和%ANAME(MASTER)%更多地在一起…真不如意啊…」
「ふふ。…好きな人とのキスって、どうしてこんなに甘いんだろうな…♥」	「fufu…和喜欢的人接吻，为什么会这么甜呢…♥」
「ん、むっ……口付け、初めてだったんだが…どうだ？」	「嗯，呜……第一次接吻…感觉如何？」
「んん…♥……はぁっ」	「唔…♥…嗯…哈~」
「こうして裸で抱き合ってのキスは、服を着ている時とはまた違った感覚だな♥」	「像这样裸着拥吻，感觉和穿着衣服的时候不一样啊♥」
「%ANAME(MASTER)%をより深く感じられる…そんな気がするよ♥」	「能更深刻的感受到%ANAME(MASTER)%…我有那种感觉♥」
「やはりこうして重ねあうだけで、凄く安心する…♥」	「果然只是这样相拥，就非常安心了……♥」
愛する%ANAME(MASTER)%とだからな…と%ANAME(TARGET)%はその後に続けるように耳元で囁いた	爱你呦%ANAME(MASTER)%...%ANAME(TARGET)%在耳边喃喃道
「ふふ…愛する人とのキスって、どうしてこんなに幸せになるんだろうな…　もっとしておくれ♥」	「fufu…只是和所爱的人相吻，为什么会变得如此幸福呢……再给我一点~♥」
「んん………はぁっ」	「唔……哈~」
「こうして裸で抱き合ってのキスは、服を着ている時とはまた違った感覚だな…」	「像这样裸着拥吻，感觉和穿着衣服的时候不一样啊…」
「%ANAME(MASTER)%をより近くで感じられる…そんな気がする♥」	「感觉能更亲近%ANAME(MASTER)%啊...有那种感觉♥」
「やはりこうして重ねあうだけで、凄く安心した気分になれる…♥」	「果然只要这样重叠在一起，就会变得非常安心…♥」
お前だからな…と%ANAME(TARGET)%はその後に続けるようにつぶやいた	因为是你啊…%ANAME(TARGET)%在那之后嘟囔着
「ふふ…好きな人とのキスって、どうしてこんなに甘いんだろうな…♥」	「呵呵…和喜欢的人接吻，为什么会这么甜呢…♥」
「ん、んむっ…」	「嗯，嗯...唔…」
「ふふ…。好きな人とのキスって、どうしてこんなに幸せに感じるんだろうな…♥」	「呵呵…和喜欢的人接吻，为什么会这么幸福呢…♥」
「ん、むっ……一応、初めての口付けだったんだが…」	「嗯，呜……虽然是第一次接吻…」
「フフッ…好きな人とのキスって、どうしてこんなに甘いんだろうな…♥」	「呵呵…和喜欢的人接吻，为什么会这么甜呢…♥」
「ん…あっ♥」	「嗯…啊♥」
「ん…あっ」	「唔……哈~」
「んんっ……はぁ♥」	「嗯……哈♥」
「あっ♥…んんっ」	「啊♥…嗯，嗯」
「んんっ……はぁ」	「嗯……哈~」
「あっ…んんっ」	「啊…嗯...唔」
「私のおっぱい…触っていいぞ♥」	「我的欧派…可以摸哦♥」
「あんっ……はぁ」	「嗯……哈~」
「ん…あぁっ♥」	「嗯…啊啊啊♥」
「あんっ♥……はぁ♥」	「嗯♥……哈♥」
「ふあぁっ♥…んっ♥」	「啊啊啊啊♥…嗯♥」
「ん…あぁっ！」	「嗯…啊啊！」
「あんっ……はぁ♥」	「嗯……哈♥」
「ふっ！　…んんっ！」	「呼！　…嗯！」
「ん…あぁっ」	「嗯…啊啊啊」
「ふっ！　…んんっ」	「呼！　…嗯，呜~」
「ふっ！　…んんっ♥」	「呼！　…啊，嗯♥」
「あっ♥……んんっ！」	「啊♥……嗯！」
「ん…あぁっ！　そこ…っ♥」	「嗯…啊啊！那里…嗯♥」
「あっ♥……んんっ♥」	「啊♥……嗯，嗯♥」
「ふあぁっ♥…ああっ♥」	「啊啊啊啊♥…啊啊♥」
「ん…あぁっ！　そこ…っ！」	「嗯…啊啊！那里…嘿！」
「ふあぁっ！　…ああっ♥」	「啊啊啊！　…啊啊♥」
「あっ……んんっ！」	「啊……嗯！」
「ふあぁっ！」	「啊啊嗯！」
「ん…あぁっ！そこ…っ♥」	「嗯…啊啊！那里…嗯♥」
「ん…あぁっ！　そこっ♥」	「嗯…啊啊！那里，那里♥」
「あっ♥……はぁっ♥」	「啊♥……哈♥」
「ん…あぁっ！　そこっ！」	「嗯…啊呜！ 那里！」
「あっ！　……はぁっ♥」	「啊！　……哈~♥」
「ふっ！…んんっ」	「呼！…啊，嗯」
「あっ♥　……はぁっ♥」	「啊♥　……哈♥」
「あっ♥　……んんっ！」	「啊♥　……嗯！」
「そんなとこ……はぁんっ♥」	「那样的地方……哈呜~♥」
「そんなとこ…んっ」	「那样的地方…嗯~」
「んん…あっ♥」	「嗯…啊♥」
「あっ♥　…んんっ」	「啊♥　…唔，嗯」
「そんなとこ…んんっ♥」	「那样的地方…呜，嗯♥」
「あっ…んんっ♥」	「啊…嗯，嗯♥」
「んん…あっ！」	「嗯…啊！」
「あっ…んんっ！」	「啊…嗯！」
「あっ…んっ」	「啊…嗯」
「ふあぁっ♥…んっ♥　私の乳首、おいしいか？　ふふ♥」	「唔啊啊啊♥…嗯~♥我的乳头好吃吗？ fufu♥」
%ANAME(TARGET)%は自分の乳首に吸い付く%ANAME(MASTER)%の頭を優しくかき抱いている	%ANAME(TARGET)%温柔地搂着吸着自己乳头的%ANAME(MASTER)%的头
「あっ♥…んんっ♥　ふふ♥　可愛いなぁ%ANAME(MASTER)%は」	「啊♥…嗯，嗯♥ fufu♥ 真可爱啊%ANAME(MASTER)%桑」
自分の乳首に吸い付く%ANAME(MASTER)%の頭を、%ANAME(TARGET)%は我が子のように優しく抱いている	%ANAME(TARGET)%像看着自己的孩子一样温柔地抱着吸着自己乳头的%ANAME(MASTER)%的头
%ANAME(TARGET)%は自分の乳首に吸い付く%ANAME(MASTER)%の頭を強く抱きしめている	%ANAME(TARGET)%紧紧抱住吸着自己乳头的%ANAME(MASTER)%的头
「はぁあっ♥　もっと私の匂いを吸い込んで…もっと乳首吸ってぇ♥」	「啊嗯♥　再多吸点我的味道…再多吸吸乳头吧♥♥」
「はぁあっ♥　もっと%ANAME(TARGET)%のおっぱい吸ってぇ♥」	「啊啊啊啊♥ 再多吸点%ANAME(TARGET)%的乳房吧♥」
「んっ♥　私の乳首、おいしいか？　ふふ♥」	「啊♥…嗯♥ 我的乳头好吃吗？呼呼♥」
「あっ♥…んんっ♥　ふふ、可愛いやつだなぁ%ANAME(MASTER)%は…」	「啊♥…嗯，嗯♥ 呵呵，真是个可爱的家伙啊%ANAME(MASTER)%桑…」
「あぁっ♥　もっと私のおっぱい吸っていいぞ…♥」	「啊嗯♥　可以再多吸吸我的乳房哦…♥」
「お、お前も“初めて”なのか？　…それじゃあ、お互いが最初の相手になるんだな…♥」	「呼，你也是第一次吗？　…那样的话，双方都会成为第一次的对象吧…♥」
「私の…%ANAME(TARGET)%の処女、もらっておくれ♥」	「我的…%ANAME(TARGET)%的纯洁，请夺走吧♥」
「お前も“初めて”なのか？　…まあ、誰でも最初は初めてだもんな」	「你也是第一次吗？　…嘛，谁开始都是第一次呢」
「初めてなんだ、優しくしておくれよ？」	「这是第一次，请温柔一点吧？」
「なんだ、“初めて”なのか？　…それじゃあ、私がお前の初めての女になるんだな…♥」	「什么，是第一次吗？　…那我就成为你的第一个女人吧…♥」
「そういうことなら優しくリードしてあげるからな…。さあ、こっちへおいで…♥」	「如果是那样的话，我会温柔地引导你的…。来，这边来…♥」
「さあ、お前のをおくれ♥」	「来，放心交给我♥」
「なんだ、童貞なのか？　ならば少しは優しくしてやろう」	「什么嘛，是处男吗？那么就温柔一点吧」
「優しくしておくれ」	「请温柔一点」
「ああっ♥　%ANAME(MASTER)%っ♥　もっと来てっ♥　%ANAME(TARGET)%を犯してぇっ♥♥」	「啊啊啊♥　%ANAME(MASTER)%~♥　再来更多♥　再狠狠地侵犯%ANAME(TARGET)%吧♥♥」
%ANAME(TARGET)%は目に♥を浮かべて%ANAME(MASTER)%の腰に脚を絡めて放さないようにしている	%ANAME(TARGET)%的眼里浮现着♥，双腿紧紧缠着%ANAME(MASTER)%的腰不放
「いっぱい私を愛しておくれ、%ANAME(MASTER)%♥」	「请多多爱我~%ANAME(MASTER)%♥」
%ANAME(TARGET)%は目に♥を浮かべて%ANAME(MASTER)%に抱きついている	%ANAME(TARGET)%的眼里浮现着♥,软倒在%ANAME(MASTER)%的怀中
「ああっ♥　%ANAME(MASTER)%っ♥　もっと来てっ♥♥」	「啊啊啊♥　%ANAME(MASTER)%~♥　再来更多♥♥」
%ANAME(TARGET)%は蕩けた顔で%ANAME(MASTER)%の腰に脚を絡めて放さないようにしている	%ANAME(TARGET)%一脸迷醉，双腿紧紧缠着%ANAME(MASTER)%の的腰不放
「もっと私を愛して…、%ANAME(MASTER)%♥」	「请多多爱我…、%ANAME(MASTER)%♥」
%ANAME(TARGET)%は蕩けた表情で%ANAME(MASTER)%に抱きついている	%ANAME(TARGET)%带着迷醉的表情抱住了%ANAME(MASTER)%
「お前も“初めて”なのか？　…まあ、焦らずにな」	「你也是第一次吗？　…啊，不要着急」
「なんだ、童貞だったのか？　…それは責任重大だな」	「什么啊，原来是处男啊？　…那是责任重大啊」
「何せお前の…“初めて”を貰う女になるわけだからな…♥」	「怎么说呢，毕竟是成为你第一次对象的女人呢…♥」
「なんだ、童貞なのか？　…なら、過度な期待はしないようにしておくよ」	「什么啊，是处男吗?……那我就不要抱太大的期待了」
「お前も“初めて”なのか？　…もうちょっとやりやすい体位の方が良かったか？」	「你也是“第一次”吗?……稍微容易一点的体位比较好吗?」
そう言って%ANAME(TARGET)%は、見目麗しいふさふさの尻尾を%ANAME(MASTER)%に絡ませながら桃尻を突き出した	这样说着，%ANAME(TARGET)%一边用美丽的毛茸茸的尾巴缠着%ANAME(MASTER)%，一边拱起了桃尻引导着
「さあ、お前のをもらうぞ♥」	「来，就这样动起来♥」
「尻尾も優しくしておくれよ」	「尾巴也要温柔地对待哦」
「ああっ♥　%ANAME(MASTER)%っ♥　もっと来てっ♥　%ANAME(TARGET)%を%ANAME(MASTER)%のモノにしてぇっ♥♥」	「啊啊啊♥　%ANAME(MASTER)%~♥　再来更多♥　把%ANAME(TARGET)%变成%ANAME(MASTER)%的东西吧♥♥」
%ANAME(TARGET)%は目に♥を浮かべて%ANAME(MASTER)%の腰に尻尾を絡めて放さないようにしている	%ANAME(TARGET)%的眼里浮现着♥，尾巴紧紧缠着%ANAME(MASTER)%的腰不放
「いっぱい私を犯してっ♥　%ANAME(MASTER)%のモノにしておくれっ♥♥」	「再更多地侵犯我吧♥　让我变成%ANAME(MASTER)%的东西吧♥♥」
%ANAME(TARGET)%は目に♥を浮かべて%ANAME(MASTER)%に腰を突き出している	%ANAME(TARGET)%的眼里浮现着♥，在%ANAME(MASTER)%上耸动着腰
%ANAME(TARGET)%は蕩けた顔で%ANAME(MASTER)%の腰に尻尾を絡めて放さないようにしている	%ANAME(TARGET)%是一副淫荡的样子，在%ANAME(MASTER)%的腰上缠着尾巴不放
%ANAME(TARGET)%は蕩けた表情で%ANAME(MASTER)%に腰を突き出している	%ANAME(TARGET)%摆着淫荡的表情，在%ANAME(MASTER)%前耸动着腰
「何せお前の…“初めて”を貰う女になるわけだからな。さあ、おいで…♥」	「怎么说呢，毕竟是要成为你第一次对象的女人呢。来，来吧…♥」
「さあ、私の傍へおいで…。私が優しく包んで、童貞卒業させてあげるからな♥」	「来，到我身边来…。我会温柔地待你，让你童贞毕业的♥」
「ふふ…、お前の顔が良く見える♥」	「fufu…你的脸看起来很舒服的样子♥」
「ああっ♥　%ANAME(MASTER)%っ♥　胸もっ♥胸もしてぇっ♥♥」	「啊呜♥　%ANAME(MASTER)%~♥　胸部那里♥欧派那...啊...♥♥」
%ANAME(TARGET)%は目に♥を浮かべて%ANAME(MASTER)%の身体に抱きついて放さないようにしている	%ANAME(TARGET)%的眼里浮现着♥，紧紧抱着%ANAME(MASTER)%的身体不放
「いっぱい突いてっ♥　%ANAME(MASTER)%のモノにしておくれっ♥♥」	「满满的进来吧♥ 要变成%ANAME(MASTER)%の东西了♥♥」
%ANAME(TARGET)%は目に♥を浮かべて腰をくねらせ、%ANAME(MASTER)%に快感を与えている	%ANAME(TARGET)%的眼里浮现着♥扭动着腰，给予着%ANAME(MASTER)%无上的快感
「あっ♥　腰っ動いちゃうっ♥」	「啊♥　腰动起来了~♥」
%ANAME(TARGET)%は蕩けた顔で%ANAME(MASTER)%の身体に抱きついて放さないようにしている	%ANAME(TARGET)%一脸迷醉，紧紧地抱着%ANAME(MASTER)%的身体不放
「もっと抱きしめておくれっ%ANAME(MASTER)%っ♥」	「请更多地拥抱我吧%ANAME(MASTER)%~♥」
%ANAME(TARGET)%は蕩けた顔で腰をくねらせ、%ANAME(MASTER)%に快感を与えている	%ANAME(TARGET)%一副迷醉的样子扭动着腰、给予着%ANAME(MASTER)%快感
「なんだ、童貞だったのか？　…それじゃあ私が、お前の“初めて”になれるんだな…♥」	「什么啊，原来是处男啊？　…那我就成为你的"第一次"了吧…♥」
「さあ、こっちへ…。ぎゅぅ、っと抱きしめながら%ANAME(MASTER)%の童貞をおくれ…♥」	「来，这边…。紧紧抱着我，把%ANAME(MASTER)%的处男交给我吧…♥」
「ぎゅっと抱きしめておくれ♥」	「请紧紧拥抱我♥」
「なんだ、“初めて”なのか？　…ふふ、それは責任重大だ」	「什么啊，是第一次吗？　…fufu，那还真是是责任重大」
「それじゃあ優しくリードしてあげるからな…。さあ、尻尾の中へおいで…♥」	「那我就温柔地引导你吧…。来，到尾巴这里来…♥」
そう言って%ANAME(TARGET)%は、見目麗しいふさふさの尻尾を%ANAME(MASTER)%に絡ませながら背を預けるように座った	这样说着，%ANAME(TARGET)%一边用美丽的毛茸茸的尾巴缠着%ANAME(MASTER)%一边坐在那里
「尻尾、邪魔じゃないか？　ふふ、じゃあ尻尾も楽しんでくれ♥」	「尾巴不碍事吗？ fufu，那尾巴也好好享受吧♥」
%ANAME(TARGET)%は目に♥を浮かべて%ANAME(MASTER)%の身体に尻尾を絡めて放さないようにしている	%ANAME(TARGET)%的眼里浮现着♥在%ANAME(MASTER)%的身体上缠绕着尾巴不放
%ANAME(TARGET)%は%ANAME(MASTER)%の身体に尻尾を絡めて放さないようにしている	%ANAME(TARGET)%用尾巴缠住%ANAME(MASTER)%的身体不放
「顔が見えないとっ♥何か、興奮するな%ANAME(MASTER)%♥」	「看不见脸的话♥有什么...好兴奋的...%ANAME(MASTER)%♥」
%ANAME(TARGET)%は蕩けた表情で腰をくねらせ、%ANAME(MASTER)%に快感を与えている	%ANAME(TARGET)%带着迷醉的表情扭动着腰、给予着%ANAME(MASTER)%无上的快感
「お前も“初めて”なのか？　…まあ、いいさ。私が動いてやろう」	「你也是第一次吗？　…那么，好吧。由我来动吧」
「実は私“初めて”なんだ。不手際があっても許しておくれ」	「其实我也是第一次。即使有不端之处，也请见谅」
「なんだ、童貞なのか？　ふふ、それはいい。何せ私が…」	「什么啊，是处男吗? 呵呵，那好。毕竟我…」
そう言うと%ANAME(TARGET)%は%ANAME(MASTER)%を優しく押し倒し、怒張した竿の根元をつかんで自らの蕩けた媚肉に押し当てる	这么说着%ANAME(TARGET)%温柔地推倒了%ANAME(MASTER)%，抓住怒张的肉棒按在自己的媚肉上
「お前の“初めて”の女になれるんだからな…♥　さあ、よく見ておくれ。%ANAME(MASTER)%のが童貞卒業するところを…♥」	「因为可以成为你“第一次”对象的女人…♥好了，请仔细看。%ANAME(MASTER)%的童贞毕业的地方…♥」
「大丈夫。優しく犯してあげるからな…♥」	「没关系。我会温柔地侵犯你的…♥」
「なんだ、童貞なのか？　ならば優しく犯してやろう」	「什么啊，是处男吗？那么就温柔地去侵犯吧」
「優しくしてやるからな」	「我会温柔地对待你的」
「ああっ♥　%ANAME(MASTER)%っ♥いいっ♥　いいよぉっ♥♥」	「哈啊...♥　%ANAME(MASTER)%~♥好棒啊♥　好舒服呀♥♥」
%ANAME(TARGET)%は目に♥を浮かべて%ANAME(MASTER)%の上で激しく腰を振っている	%ANAME(TARGET)%的眼里浮现着♥在%ANAME(MASTER)%上激烈地摆动着腰
「止まらないっ♥　%ANAME(MASTER)%を犯すのっ♥止まらないぃっ♥」	「停不下来啊♥　侵犯着%ANAME(MASTER)%♥停不下来啊~♥」
%ANAME(TARGET)%は目に♥を浮かべて前後に腰を振り、%ANAME(MASTER)%に快感を与えている	%ANAME(TARGET)%的眼里浮现着♥前后摆动着腰给予着%ANAME(MASTER)%无上的快感
「ああっ♥　%ANAME(MASTER)%のっ♥いいよぉっ♥♥」	「哈啊...♥　%ANAME(MASTER)%的~♥好棒啊♥♥」
%ANAME(TARGET)%は蕩けた顔で%ANAME(MASTER)%の上で激しく腰を振っている	%ANAME(TARGET)%一副迷醉的样子%ANAME(MASTER)%上激烈地摆动着腰
「%ANAME(MASTER)%を犯すのっ♥キモチいぃっ♥」	「侵犯着%ANAME(MASTER)%♥感觉好棒♥」
%ANAME(TARGET)%は蕩けた顔で前後に腰を振り、%ANAME(MASTER)%に快感を与えている	%ANAME(TARGET)%一副迷醉的样子前后摆动着腰给予着%ANAME(MASTER)%无上的快感
「お前も“初めて”なのか？　…まあ、いいさ。いざとなれば私が動いてやろう」	「你也是“第一次”吗?……那么，好吧。有必要的话，我来动吧」
「初めてなんだ、暴れないでおくれよ？」	「这是第一次，请不要胡闹哦？」
「なんだ、童貞だったのか？　ふふ、それは良かった。何せ私が…」	「什么啊，原来是处男啊？fufu，那太好了。反正我…」
「%ANAME(MASTER)%の“初めて”の女になれるんだからな…♥　さあ、よく見てて。このチンポが童貞卒業するところを…♥」	「因为能成为%ANAME(MASTER)%的第一个女人啊…♥来，仔细看。这个小鸡鸡处男毕业的时候…♥」
「さあ、今から挿れるからよく見ておくれ…♥」	「那么，现在开始插咯，请仔细看…♥」
そう言うと%ANAME(TARGET)%は%ANAME(MASTER)%に背を向けて跨り、怒張した竿の根元をつかんで自らの媚肉に押し当てる	这么说着，%ANAME(TARGET)%背向%ANAME(MASTER)%跨过去，抓住怒张的肉棒，将自己的媚肉推开
「さあ、優しく犯してやるからな…♥」	「那么，温柔地去侵犯吧…♥」
「なんだ、童貞なのか？　ならば優しくしてやろう」	「什么啊，是处男吗？那么就温柔一点吧」
「暴れないでおくれよ？」	「别闹了吧？」
「なんだ、“初めて”だったのか？　それじゃあもうちょっとやりやすい体位が良かったかな…」	「什么啊，是第一次吗？那样的话，更容易做的体位比较好吧…」
「まあ、いいさ。私のココで、キモチよく童貞卒業しておくれ♥」	「好吧，好吧。在我这里，请好好地处男毕业吧♥」
「さあ、いいぞ…。ぎゅぅ、っと抱きしめながら%ANAME(MASTER)%の童貞をおくれ…♥」	「好了，就这样…紧紧地抱着我，把%ANAME(MASTER)%的处男给我…♥」
「尻尾もぎゅっと抱きしめておくれ♥」	「尾巴也紧紧地抱住吧♥」
「私の尻穴…、味わっておくれ♥」	「我的尻穴…、尽情感受吧♥」
「優しく入れておくれよ？」	「温柔地放进去吧？」
「まずはお互いのことをもっと知ることから始めようか」	「首先从了解彼此开始吧」
「まずはお互いのことを知ることから始めましょう」	「首先从彼此相识开始吧」
「何でもない雑談でも、%ANAME(MASTER)%となら幸せな一時になるんだ」	「即使是无聊的闲谈，能与%ANAME(MASTER)%在一起渡过的话也是幸福的一段时间」
%ANAME(TARGET)%は笑顔で%ANAME(MASTER)%との会話を楽しんでいる	%ANAME(TARGET)%笑着享受与%ANAME(MASTER)%的对话
「%ANAME(MASTER)%と話すのはすごく楽しいな…。日々の気疲れが消えていくよ」	「与%ANAME(MASTER)%交谈实在有趣…感觉每天的疲劳都消失了呢」
%ANAME(TARGET)%は優秀であるが故、日々多くの仕事をこなしているがやはり負担は大きいようだ	因为%ANAME(TARGET)%很优秀的缘故，所以每天做很多工作，但负担还是蛮重的
%ANAME(MASTER)%はそれとなく%ANAME(TARGET)%を労わった	%ANAME(MASTER)%让%ANAME(TARGET)%注意别太辛苦了
「ふふ、そんなにヤワではないつもりだよ。でもありがとう、%ANAME(MASTER)%♥」	「fufu，我也没打算做的太过。但是谢谢你，%ANAME(MASTER)%♥」
前に%ANAME(MASTER)%が行ったことのある景色の良い場所について話した	说了关于以前%ANAME(MASTER)%去过的风景秀丽的地方
「今度、そこに行ってみないか？　二人っきりで…な♥」	「下次要不要去那里看看？只有两个人哦…呼呼♥」
「この尻尾？　確かにケアが大変だよ。でも最近は%ANAME(MASTER)%が手伝ってくれて助かってるよ」	「尾巴吗？确实护理很辛苦。但是最近%ANAME(MASTER)%帮了我大忙了」
%ANAME(TARGET)%は%ANAME(MASTER)%の腕を抱きながら寄り添ってきた	%ANAME(TARGET)%一边抱着%ANAME(MASTER)%的手臂一边靠近着
「こうしていると安心するんだ…このまま話しても構わないか？」	「这样的话就安心了…这样可以吗？」
わざわざ断る理由もない。%ANAME(MASTER)%は%ANAME(TARGET)%の申し出を快諾した	也没有什么拒绝的理由。%ANAME(MASTER)%欣然答应了%ANAME(TARGET)%的提议
「ふふ…ありがとう、%ANAME(MASTER)%♥」	「fufu…谢谢你，%ANAME(MASTER)%♥」
「あ！　%ANAME(MASTER)%、あの店の油揚げ料理は絶品だぞ。今度二人で食べに行こう♪」	「啊！%ANAME(MASTER)%，那家店的油炸食品可是极品哦。下次两个人一起去吃吧♪」
%ANAME(TARGET)%は笑顔で%ANAME(MASTER)%との他愛ない会話を楽しんでいる	%ANAME(TARGET)%笑着，与%ANAME(MASTER)%聊着漫无天际的话
「自分では頑張っているつもりなんだが、それでもあの方の期待には添えられていないようで…。己の未熟さを痛感するよ」	「我自认为很努力，但是那个人的期待却没有增加…。痛感自己的不成熟」
「…弱気なところを見せてすまない。%ANAME(MASTER)%が相手だと、何でも話せてしまっていけないな」	「……不好意思让你看到我软弱的一面。如果对方是%ANAME(MASTER)%的话，那就什么都能倾诉呢」
九尾である%ANAME(TARGET)%にも、%ANAME(TARGET)%なりの苦悩があるようだ。それを打ち明けられる関係になれたことがなんとなしに嬉しかった	作为九尾的%ANAME(TARGET)%也有%ANAME(TARGET)%的苦恼。能把这件事坦白出来，我很高兴
%ANAME(MASTER)%は%ANAME(TARGET)%の手を取り、またいつでも話を聞くよ、と告げると%ANAME(TARGET)%ははにかむような笑顔を見せた	%ANAME(MASTER)%牵着%ANAME(TARGET)%的手，告诉她什么时候都可以倾听她说话，%ANAME(TARGET)%露出了腼腆的笑容
「何でもない雑談でも、%ANAME(MASTER)%となら楽しい一時になるよ」	「即使是无聊的闲谈，能与%ANAME(MASTER)%在一起渡过的话也是快乐的一段时间」
「%ANAME(MASTER)%と話すのはとても楽しいな…日々の気疲れが消えていくようだよ」	「与%ANAME(MASTER)%交谈实在有趣…感觉今天的疲劳都消失了呢」
前に%ANAME(MASTER)%が行ったことのある場所について話した	说了关于以前%ANAME(MASTER)%去过的地方
「ゆっくり出来るなら、そこに行って見たいものだな」	「如果有时间的话，真想去那里看看啊」
「お前はきつねうどんとたぬきそば、どちらが好きだ？」	「你喜欢油炸豆腐面还是油炸豆腐面？」
%ANAME(TARGET)%は%ANAME(MASTER)%との会話を楽しんでいる	%ANAME(TARGET)%享受着和%ANAME(MASTER)%的对话
「ほう、私にもまだまだ知らないことがあるんだな」	「这样啊，我也还有很多不知道的事情呢」
「うん、私もそう思うよ」	「嗯，我也这么认为」
「で、その油揚げはどうなったんだ？」	「那么，那个油炸豆腐怎么样了？」
%ANAME(TARGET)%は目を輝かせながら%ANAME(MASTER)%の話を聞いている	%ANAME(TARGET)%眼睛闪闪发光地听着%ANAME(MASTER)%的话
「で、その油揚げはどうなったんです？」	「那么，那个油炸豆腐怎么样了？」
「私もまだまだ知らないことばかりです」	「我也还有很多不知道的事情啊」
「ええ、私もそう思います」	「是的，我也这么认为」
「まずは実力を見せてもらおうか、本気でかかってこい！」	「首先让我看看你的实力吧，认真地对待吧！」
「まずは実力を見せてもらいましょう」	「首先让我看看你的实力吧」
「訓練といえど本気で行くぞ。さあ、%ANAME(MASTER)%も全力で」	「虽说是训练，但我会认真对待的。来吧，%ANAME(MASTER)%也要全力以赴」
「基本はできているようだ。関心関心♪」	「基本上做的不错。関心関心♪」
%ANAME(TARGET)%は%ANAME(MASTER)%の上達ぶりに満足しているようだ	%ANAME(TARGET)%似乎对%ANAME(MASTER)%的进步感到满意
「予想以上の動きだった。私のいない間に訓練でもしていたのか？」	「动作超出了预想。你在我不在的时候也在做训练吗？」
%ANAME(MASTER)%はそのとおりと胸を張った	%ANAME(MASTER)%理所当然地挺起了胸膛
%ANAME(TARGET)%は微笑むと、%ANAME(MASTER)%の頭を優しく撫でた	%ANAME(TARGET)%微笑着，温柔地抚摸着%ANAME(MASTER)%的头
「基本がなってないんだな。いいか、こうして…」	「没有基本啊。听好了，就这样…」
%ANAME(MASTER)%に教えるように図で解説している	%ANAME(MASTER)%像这样用图来解说教导着
「まだまだ粗い、が、中々いい動きもあったよ」	「虽然还很粗糙，但是也有很好的动作哦」
「筋が良い…これは私もうかうかしてられないな」	「肌肉还不错…这样的话我也不能大意啊」
「手加減したほうが良かったですか？」	「手下留情比较好吗？」
「訓練といえど、気は抜きませんように」	「虽说是训练，但也不要放松」
「いい運動になります」	「是个好运动」
「予想以上の動きだった。私のいない間に特訓でもしていたのか？」	「动作超出了预想。你在我不在的时候也在做训练吗？」
「戦は兵が物をいう。それを動かす兵法の習得は必須だ。ちゃんと覚えるんだぞ？」	「战由兵说了算。掌握使之行动的兵法是必须的。你要好好记住啊?」
「戦は兵が物をいいます。それを動かす兵法の習得は必須です」	「战由兵说了算。掌握使之行动的兵法是必须的」
「私は他の大妖怪ほど腕っ節は強くないが、こういう分野なら得意なんだ」	「我虽然没有其他大妖怪那样强大，但是在这个领域我很擅长」
「戦場で危ないと思ったら私の傍に居ろ。必ず守って見せるから」	「如果觉得在战场上危险的话就在我身边。我一定会保护你的」
「古の名将たちのように、華麗に兵を操ってみたいものだ。%ANAME(MASTER)%はどうだ？」	「像古代的名将们那样，想华丽地操纵军队。%ANAME(MASTER)%觉得如何？」
%ANAME(TARGET)%は%ANAME(MASTER)%に兵法の何たるかを熱く語っている	%ANAME(TARGET)%对%ANAME(MASTER)%热情洋溢地讲着兵法
「調子はどうだ？　分からないところがあったら気軽に言ってくれ」	「感觉怎么样？有不明白的地方尽管说」
「私で良ければいつでも%ANAME(MASTER)%の力になるからな」	「如果可以的话，我随时都会成为%ANAME(MASTER)%的力量」
「「戦は兵が物をいう。それを動かす兵法の習得は必須だ」	「战由兵说了算。掌握使之行动的兵法是必须的」
「武を生かすも殺すも策次第。覚えると病みつきになるぞ」	「无论是活用还是杀死，都要取决于对策的。记住的话就会感觉好很多」
「考えることは好きだ。%ANAME(MASTER)%はどうだ？」	「我喜欢思考。%ANAME(MASTER)%觉得如何？」
「武を生かすも殺すも策次第です」	「无论是活用还是杀死，都要取决于对策的」
「考えることは好きです」	「我喜欢思考」
「式の本領発揮だな」	「要发挥本式神的本领了」
「式の本領をお見せします」	「让你看看本式神的本领」
「政治に興味がある？　それは結構！　政は戦いとは違った楽しみがあるぞ%ANAME(MASTER)%！」	「对政治有兴趣吗？那很好！政治和战斗有着不同的乐趣哦%ANAME(MASTER)%！」
%ANAME(TARGET)%は%ANAME(MASTER)%に政の奥深さを語っている	%ANAME(TARGET)%向%ANAME(MASTER)%讲述了政治的奥秘
%ANAME(TARGET)%はものすごい速さで書類の山を片付けている	%ANAME(TARGET)%以惊人的速度处理着堆积如山的文件
「%ANAME(MASTER)%、もうちょっと待っててくれ。すぐ終わるから」	「%ANAME(MASTER)%，再稍等一下。马上就结束了」
%ANAME(TARGET)%は、人間なら一日がかりであろう仕事量を１時間足らずで終わらせてしまった	%ANAME(TARGET)%在不到一个小时的时间内完成了普通人一天的工作量
「ふふん、結界の管理・修復に比べたら軽いものだよ」	「fufu，和结界的管理与修复相比这算轻松的」
%ANAME(TARGET)%は得意げに%ANAME(MASTER)%にアピールしている	%ANAME(TARGET)%得意地向%ANAME(MASTER)%夸耀着
「こういうのは私の得意分野だな」	「这是我擅长的领域啊」
%ANAME(TARGET)%はすごい速さで書類の山を処理している	%ANAME(TARGET)%以惊人的速度处理着堆积如山的文件
「こういう仕事は私の得意とするところだ」	「这种工作是我的拿手的」
「式の本領発揮です」	「发挥本式神的本领」
「こういうのは私の得意分野です」	「这是我的拿手好戏」
「秩序を保つためにも見回りは大切な仕事だ」	「为了保持秩序，巡视也是很重要的工作」
「秩序を保つためにも見回りは必要です」	「为了保持秩序也需要巡视」
「あ、%ANAME(MASTER)%。あそこの稲荷寿司な、油揚げの味付けが絶品なんだ。今度一緒に行かないか？」	「啊，%ANAME(MASTER)%。那里的稻荷寿司，油炸豆腐的味道真是绝品。下次一起去吧？」
%ANAME(TARGET)%は見回りの途中、お気に入りの店を%ANAME(MASTER)%に紹介している	%ANAME(TARGET)%在巡视途中，把自己喜欢的店介绍给了%ANAME(MASTER)%
「分かった。さあ行こう、%ANAME(MASTER)%」	「知道了。那么走吧，%ANAME(MASTER)%」
%ANAME(TARGET)%は%ANAME(MASTER)%の腕を取って歩いている	%ANAME(TARGET)%挽着%ANAME(MASTER)%的手臂走着
「公私は分けるべきとは思うんだが…、一緒にいるとついつい甘えたくなってしまう…」	「公私应该分明…但在一起的时候不知不觉就想撒娇了…」
%ANAME(TARGET)%は%ANAME(MASTER)%の腕に抱きつきながら見回りしている	%ANAME(TARGET)%抱住%ANAME(MASTER)%的手臂环视着
「妖のたぐいは私が見張る。そっちは人間のゴロツキ等がいたら頼む」	「我来监视妖怪之类的。如果那里有人类找麻烦的话就拜托你了」
「私が見回れば、木っ端妖怪は大人しくしているだろう」	「我巡查的话，小妖会很老实很多吧」
「秩序を保つためにも見回りは必要なものだ。しっかりやろう」	「为了保持秩序，巡视也是必要的。好好干吧」
「私が見回れば、木っ端妖怪は大人しくしていましょう」	「我看了一下，小妖怪还蛮老实的」
「…歌は苦手なんだ」	「…我不擅长唱歌啊」
「…歌は苦手です」	「…我不擅长唱歌」
「…今のところ、抑揚がおかしくなかったか？」	「…到目前为止，音调会奇怪吗？」
%ANAME(TARGET)%は真面目に発声練習に精を出している	%ANAME(TARGET)%认真地致力于发声练习
「喋るだけとは勝手が違って…」	「这和光说是不一样的…」
「ある程度は出来るつもりだけど、料理上手というほどでは…」	「我想一定程度上可以做，但并不是说是我擅长的料理……」
「そこそこくらいなら出来ますよ」	「差不多的话就可以」
「何？　味見させてほしい？　仕方ないなぁ、ほら、あーんして」	「什么...你想让我喂你？...真没办法啊，来，啊~~」
%ANAME(MASTER)%が口を開けると、%ANAME(TARGET)%はその要望に応えた	%ANAME(MASTER)%嘴巴张着、%ANAME(TARGET)%回应了这个要求
%ANAME(MASTER)%が美味しいと伝えると、%ANAME(TARGET)%は満足そうに微笑んだ	当%ANAME(TARGET)%告诉她%ANAME(MASTER)%很好吃时，她满足地微笑着
「口に合うだろうか…どうかな？」	「合不合口味…觉得怎么样？」
%ANAME(MASTER)%は素直に%ANAME(TARGET)%の料理を絶賛した。%ANAME(TARGET)%も得意げな顔で%ANAME(MASTER)%を見つめている	%ANAME(MASTER)%坦率地称赞了%ANAME(TARGET)%的料理。%ANAME(TARGET)%也得意地看着%ANAME(MASTER)%
「私の料理を食べて、笑顔になってくれるだけで嬉しいんだ」	「吃了我做的料理，只要你露出笑容我就很开心了」
「良かったら…、これからも食べて欲しいな…」	「如果可以的话…希望今后你也能一直吃下去…」
「紫様はお忙しい方なので、大体の食事は私が用意しているんだ」	「因为紫大人很忙，所以大部分的饭都是我准备的」
%ANAME(TARGET)%は手際よく下ごしらえをこなしている	%ANAME(TARGET)%手没停地说着
「料理はけっこう作ったりしているよ」	「做了很多料理哦」
%ANAME(TARGET)%は手際よく食材に包丁を入れている	%ANAME(TARGET)%很灵巧地用菜刀切菜
「普段から包丁は触ってますので」	「因为平时就经常碰菜刀」
「凝った物は作れませんが、これくらいなら…」	「我做不出精致的东西，但如果是这个程度的话…」
「式が剥がれないかって？　これくらいの対策は万全だよ」	「式符会不会剥落？这已经做好了完全的对策了」
「式が剥がれないかって？　これくらいの対策は万全です」	「式符会不会剥落？做了完全的对策了」
「こうしてくっついていると温もりを感じて…二人で溶け合うようだな…♥」	「这样粘在一起的话会感到温暖……两个人好像融合在一起了呢…♥」
「たまには、こういうのもいいものだな♥」	「偶尔这样也不错啊♥」
「もっと…くっついてもいいんだぞ♥」	「更…可以更多地粘在一起哦♥」
「あんまり変なとこは触らないでくれよ？」	「不要碰太奇怪的地方哦？」
「まぁ、親交を深めるには有りですが…」	「嘛，虽然有加深亲密交往的必要…」
%ANAME(TARGET)%は尻尾を広げて%ANAME(MASTER)%を誘っている	%ANAME(TARGET)%张开尾巴，诱惑着%ANAME(MASTER)%
「ふふ♥　お前の好きにしていいんだぞ？」	「fufu♥　可以随你喜欢哦？」
%ANAME(MASTER)%はその誘惑に乗っかり、尻尾に飛びついて幸せのモフモフタイムを堪能した	%ANAME(MASTER)%被诱惑着，扑向尾巴，享受着幸福的mofumofu时间
「ふふ♥　私の尻尾、いい手触りだろう？　お前ならいくらでも触っていいんだぞ♪」	「fufu♥　我的尾巴，手感不错吧？如果是你的话，不管怎么碰都可以哦♪」
「あ…♥　エッチな触り方だな。でも%ANAME(MASTER)%なら、もっと先まで構わないぞ♥」	「啊…♥　真是瑟琴的抚摸方式啊。但是如果是%ANAME(MASTER)%的话吗，可以更进一步哦♥」
%ANAME(TARGET)%は自慢の尻尾で%ANAME(MASTER)%の顔を撫でるように弄んでいる	%ANAME(TARGET)%用自己引以为傲的尾巴抚摸着%ANAME(MASTER)%的脸
「ふふ♥　蕩けた良い顔だ…そんなに私の尻尾が好きなのか。もっとしてやるからな♥」	「fufu♥　真是一脸好色的样子啊…这么喜欢我的尾巴吗。那么就再给你做更多♥」
%ANAME(MASTER)%は%ANAME(TARGET)%の尻尾を堪能しつつ、お尻をそっと撫でた	%ANAME(MASTER)%一边享受着%ANAME(TARGET)%的尾巴，一边轻轻抚摸着她的臀部
「あんっ♥　…もう、%ANAME(MASTER)%ったら。そんな触り方では欲求不満になっちゃうぞ♥」	「哈啊♥　…呜、%ANAME(MASTER)%桑。这种触摸方式只会让人欲求不满哦♥」
「この尻尾は私の自慢なんだ。%ANAME(MASTER)%にだったら好きにしていいからな♥」	「这尾巴是我的骄傲。但如果是%ANAME(MASTER)%的话那就随你喜欢摆弄吧♥」
%ANAME(TARGET)%は%ANAME(MASTER)%に抱きつきながらふわふわの尻尾を絡めてくる	%ANAME(TARGET)%一边抱着%ANAME(MASTER)%一边还用蓬松柔软的尾巴缠绕着在一起
「んん…♥　もっと触っておくれ……♥」	「嗯…♥请再多摸一些……♥」
%ANAME(MASTER)%は%ANAME(TARGET)%の大きな尻尾を存分にモフモフしている	%ANAME(MASTER)%尽情地抚摸着%ANAME(TARGET)%的大尾巴
「尻尾に包まれてみたい？　ふふ、贅沢なお願いだな。さあ、おいで♥」	「想被尾巴包围吗？fufu，真是奢侈的愿望啊。好吧，过来这边♥」
%ANAME(TARGET)%は%ANAME(MASTER)%をふわふわの尻尾で抱き包んだ	%ANAME(TARGET)%用软绵绵的尾巴抱住了%ANAME(MASTER)%
そのモフモフ具合は極上の感触で、%ANAME(MASTER)%はしばし恍惚としていた…	那mofumofu的极好的触觉，%ANAME(MASTER)%暂时恍惚着…
%ANAME(MASTER)%が%ANAME(TARGET)%と触れ合っていると、%ANAME(TARGET)%は尻尾で%ANAME(MASTER)%を抱き寄せてきた	当%ANAME(MASTER)%和%ANAME(TARGET)%接触的时候，%ANAME(TARGET)%用尾巴抱着%ANAME(MASTER)%
「ふふ♥　もっと%ANAME(MASTER)%の温もりを感じさせておくれ…」	「fufu♥请让我感受更多%ANAME(MASTER)%的温暖…」
「%ANAME(MASTER)%。すまないがちょっとマッサージをしてくれないか？　お前に触ってもらえたらコリも解れると思うんだ」	「%ANAME(MASTER)%。不好意思，能帮我按摩一下吗？我想如果能让你按摩我的话，我想酸痛也能缓解」
%ANAME(MASTER)%が愛情を込めた肩揉みマッサージを始める。指が柔肌を揉み込む度、%ANAME(TARGET)%が恍惚とした艶声を漏らす	%ANAME(MASTER)%带着爱意开始按摩肩膀。每当手指揉进柔软的肌肤，%ANAME(TARGET)%就会露出恍惚的艳声
「ぁん、…はぁ…♥…とても気持ち良いよ、%ANAME(MASTER)%。…次は背中とか…腰とかもお願いしたいな…♥」	「嗯…哈…♥…很舒服哦，%ANAME(MASTER)%。…接下来是背…腰什么的也拜托你了…♥」
%ANAME(TARGET)%は目を細め、もっと触って欲しいというように身体をいやらしくくねらせ%ANAME(MASTER)%を誘惑している	%ANAME(TARGET)%眯起眼睛，不安地扭动身体，想要更多的触摸的诱惑着%ANAME(MASTER)%
「ふふ♥　好きにしてもいいんだぞ？」	「fufu♥ 可以随你喜欢责弄哦？」
%ANAME(MASTER)%はその言葉に従い、尻尾に飛びついてモフモフを堪能した	%ANAME(MASTER)%遵从她的话，扑到了尾巴上，十分满足
「ふふ…私の尻尾、いい手触りだろう？　もっと触っていいんだぞ♪」	「fufu…我的尾巴触感很好吧？可以再摸一下哦♪」
「ふふ…エッチな触り方だが…%ANAME(MASTER)%なら許してやるぞ♥」	「呵呵…真是色情的触摸方式呢…但如果是%ANAME(MASTER)%的话我就原谅你♥」
「あんっ、…もう、変なところ触って。オシオキだ♥」	「嗯…快摸到奇怪的地方了~是骗你的~♥」
%ANAME(TARGET)%は自慢のふわふわ尻尾で%ANAME(MASTER)%の顔を撫でるように弄んでいる	%ANAME(TARGET)%用它引以为傲的蓬松尾巴抚摸着%ANAME(MASTER)%的脸。
%ANAME(MASTER)%は%ANAME(TARGET)%の尻尾を堪能しつつ、尻をそっと撫でた	%ANAME(MASTER)%一边享受着%ANAME(TARGET)%的尾巴，一边轻轻抚摸着她的臀部
「ひゃんっ　…もう、%ANAME(MASTER)%ったら♪」	「啊啦…过界了哦，%ANAME(MASTER)%~♪」
%ANAME(TARGET)%は声を上げながらも%ANAME(MASTER)%の手を払おうとはせず、むしろもっと触って欲しいとばかりに身体を寄せてきた	%ANAME(TARGET)%一边说着，却没有拂去%ANAME(MASTER)%的手，反而是想让%ANAME(TARGET)%更多触摸似的将身体靠了过来。
「尻尾に入ってみたい？　ふふ、良いとも。さあどうぞ♥」	「想进入尾巴吗？fufu，好的。来吧♥」
%ANAME(TARGET)%は%ANAME(MASTER)%にふわふわの尻尾を向けてくれた	%ANAME(TARGET)%把软绵绵的尾巴朝向了%ANAME(MASTER)%
「%ANAME(MASTER)%。すまないがちょっと肩を揉んでくれないか？　最近疲れが溜まり気味で…」	「%ANAME(MASTER)%。对不起，可以帮我揉肩吗？最近有点累了…」
%ANAME(MASTER)%は%ANAME(TARGET)%のお願いに応え、労わる気持ちを込めてマッサージを始める	%ANAME(MASTER)%回应了%ANAME(TARGET)%的请求，带着犒劳的心情开始按摩
「んん…はぁ……良い力加減だ。とても気持ち良いよ、%ANAME(MASTER)%…」	「嗯…哈……力量很不错。很舒服哦，%ANAME(MASTER)%…」
%ANAME(TARGET)%は目を細めて恍惚とした様子で%ANAME(MASTER)%に肩を揉ませている	%ANAME(TARGET)%眯起眼睛神情恍惚地让%ANAME(MASTER)%揉着肩膀
「尻尾、触りたいか？　%ANAME(MASTER)%になら許すぞ」	「想摸尾巴吗？如果是%ANAME(MASTER)%的话就原谅你」
%ANAME(TARGET)%はスキンシップを図る%ANAME(MASTER)%に自慢の尻尾を絡ませている	%ANAME(TARGET)%向谋求亲密接触的%ANAME(MASTER)%身上缠绕着引以为豪的尾巴
「尻尾でくすぐられるの、嬉しそうだな…♪」	「被尾巴挠了，看起来很开心啊…♪」
「私の尻尾がそんなに気になるか？」	「你那么在意我的尾巴吗？」
%ANAME(TARGET)%の問いに、%ANAME(MASTER)%は首を縦に振って肯定した	对于%ANAME(TARGET)%的提问，%ANAME(MASTER)%点着头肯定了
「ふむ…じゃあちょっとだけだぞ？　優しく触っておくれよ」	「嗯…那么只能一点点哦？请温柔地触摸哦」
「ちょっと肩を叩いてくれないか？　最近疲れることが多くて…」	「可以帮我拍一下肩膀吗？最近累的事很多…」
「手を繋ぎたいか？　…ふふ、これくらいいつでも言ってくれ」	「想牵手吗？　…呵呵，这些话什么时候都可以说」
「そんなに尻尾が気になるか？」	「你那么在意尾巴吗？」
%ANAME(MASTER)%は尻尾を触ってみたい旨を伝えた	%ANAME(MASTER)%告诉他想摸摸尾巴
「ふうん…でもまだ駄目だ。そんな安い尻尾じゃないぞ」	「嗯…但是还不行。我的尾巴不是那么随便能摸的」
「あんまりへんなとこは触るんじゃないぞ？」	「不要碰太奇怪的地方哦？」
「手を繋ぎたい？　まあ、それくらいは…」	「想牵手吗？那么，就一下…」
「尻尾が気になりますか？　でも触らないようにしてくださいね。手入れが大変ですので」	「你在意尾巴吗？但是请不要碰哦。因为护理很麻烦的」
「へんな所は触らないでください」	「请不要碰奇怪的地方」
「手を繋ぎたい？　まあ、それくらいなら…」	「想牵手吗？嗯，那样的话…」
%ANAME(MASTER)%は%ANAME(TARGET)%に甘えるように抱きついた	%ANAME(MASTER)%像在%ANAME(TARGET)%中撒娇般地抱住了她
「んん？　甘えたいのか？　ふふ♥　しょうがないなぁ、%ANAME(MASTER)%は…♥」	「嗯？想撒娇吗？fufu♥ 真拿你没办法啊，%ANAME(MASTER)%…♥」
%ANAME(TARGET)%は%ANAME(MASTER)%の頭と背中をポンポンと撫で、柔らかい尻尾で抱き包んだ	%ANAME(TARGET)%抚摸着%ANAME(MASTER)%的头和背同时用柔软的尾巴抱着
「ふふ♥　私の尻尾、いい手触りだろう？　いくらでも触ってくれていいんだぞ♪」	「fufu♥我的尾巴触感很好吧？不管怎么样碰都可以哦♪」
「あ…♥　エッチな触り方だな。でも%ANAME(MASTER)%ならもっと先まで構わないぞ♥」	「啊…♥真是色情的触摸方式啊。但是如果是%ANAME(MASTER)%的话，再进一步也没关系哦♥」
%ANAME(MASTER)%は%ANAME(TARGET)%の耳を甘噛みした	%ANAME(MASTER)%亲密地咬住了%ANAME(TARGET)%的耳朵
「ひゃん！　耳は弱いんだ…だから、優しくしておくれ♥」	「呼呜~！耳朵很敏感的…所以，请温柔一点♥」
「この尻尾は私の自慢なんだ。%ANAME(MASTER)%にだったら、好きにしてくれていいからな♥」	「这尾巴是我的骄傲。如果是%ANAME(MASTER)%的话，你可以随意抚摸哦♥」
「んん…♥　%ANAME(MASTER)%の撫で方、とても気持ちいいよ…♥」	「嗯…♥%ANAME(MASTER)%的抚摸方法，非常舒服哦…♥」
「尻尾に包まれてみたい？　ふふ、他ならぬ%ANAME(MASTER)%の頼みなら構わないよ♥」	「想被尾巴包围吗？ fufu，既然是%ANAME(MASTER)%的请求的话没关系哦♥」
「え、膝枕してほしい？　ふふ、構わないぞ。ほら、おいで♥」	「嗯，你想枕膝吗？fufu，没关系，来，到这里♥」
%ANAME(TARGET)%は%ANAME(MASTER)%の頭を柔らかな太ももで迎え、その頭を愛おしそうに撫でる	%ANAME(TARGET)%用柔软的大腿迎接%ANAME(MASTER)%的头，爱抚着
「%ANAME(MASTER)%、気持ちいいか？　……ふふ、それは良かった」	「%ANAME(MASTER)%，舒服吗？　……fufu，那太好了」
「え？　マッサージをしてくれるのか？　ふふ、ありがとう。%ANAME(MASTER)%に触ってもらえたらコリも解れるよ」	「啊？可以给我按摩吗？fufu，谢谢。如果被%ANAME(MASTER)%摸的话，可以解开酸痛哦」
%ANAME(MASTER)%が愛情を込めた肩揉みマッサージを始める。指が柔肌を揉み込む度、%ANAME(TARGET)%から恍惚とした艶声をが漏れる	%ANAME(MASTER)%带着爱意开始按摩肩膀。每当手指揉进柔软的肌肤，%ANAME(TARGET)%就会发出恍惚的美艳声
「ぁん、…はぁ…♥…とても気持ち良いよ、%ANAME(MASTER)%。…次は背中とか…腰とかもしてほしいな…♥」	「嗯…哈…♥…很舒服哦，%ANAME(MASTER)%。…接下来是背…还有腰部…♥」
%ANAME(TARGET)%は目を細めてもっと触って欲しいというように身体をいやらしく震わせ、%ANAME(MASTER)%を無意識に誘惑している	%ANAME(TARGET)%眯起眼睛，像是想让她多摸一碰似的，让身体舒服地颤抖着，无意识地诱惑着%ANAME(MASTER)%
「ん？　甘えたいのか？　ふふ、しょうがないなぁ」	「嗯？想撒娇吗？fufu，真没办法啊」
%ANAME(TARGET)%は尻尾で%ANAME(MASTER)%を撫でるように抱き包んだ	%ANAME(TARGET)%用尾巴像抚摩%ANAME(MASTER)%一样地抱在怀里
「ひゃあっ！　耳は…弱いんだ…っ！」	「呼呜！耳朵…很敏感的…呜！」
「ひゃんっ！　…もう、%ANAME(MASTER)%ったら♪」	「哎呀！　…已经过界了哦，%ANAME(MASTER)%了♪」
「ん？　肩を揉んでくれるのか？　それは助かるよ。最近疲れが溜まり気味で…」	「嗯？可以帮我揉肩膀吗？那可帮大忙了。最近有点累了…」
%ANAME(MASTER)%は%ANAME(TARGET)%を労わる気持ちを込めてマッサージを始めた	%ANAME(MASTER)%怀着犒劳%ANAME(TARGET)%的心情开始按摩
%ANAME(TARGET)%は目を細めてリラックスした様子で%ANAME(MASTER)%に肩を揉まれている	%ANAME(TARGET)%眯着眼睛放松的样子被%ANAME(MASTER)%揉着肩膀
「尻尾を触りたい？　%ANAME(MASTER)%になら許すぞ」	「想摸尾巴吗？如果是%ANAME(MASTER)%的话就特许你」
「そんなに尻尾が気になるのか？」	「你那么在意尾巴吗？」
「ふむ…じゃあちょっとだけ触っていいぞ。乱暴にはしないでくれよ？」	「嗯…那就稍微碰一下吧。不要太粗暴哦？」
「ははっ、くすぐったいよ」	「哈哈，好痒啊」
「手を繋ぎたい？　それくらいお安い御用さ」	「想牵手吗？那么简单的事」
「…子ども扱いしているわけではないよな？」	「…你没有把我当孩子看待吧？」
「…子ども扱いしているわけではないですよね？」	「…不是当做孩子看待的吧？」
「んん…～♪」	「嗯…～♪」
%ANAME(TARGET)%は実に気持ちよさそうに頭を撫でられている	%ANAME(TARGET)%好像很舒服似的被抚摸着头
「ふふ、尻尾も撫でてくれていいんだぞ？」	「呵呵，可以抚摸下我的尾巴吗？」
「…ふふ、好きな人に撫でられるのって、とても気持ちがいいな…」	「…呵呵，被喜欢的人抚摸，感觉很舒服啊…」
「心を込めて撫でてくれよ？」	「用心地抚摸我吧？」
自分が撫でられることに慣れていないのか、%ANAME(TARGET)%は戸惑い気味だ	不习惯自己被抚摸吗，%ANAME(TARGET)%有点不知所措
「…髪は乱さないようにしてくれ…」	「…请不要弄乱头发…」
「…髪は乱さないようにしてくださいね」	「…请不要弄乱头发哦」
「…もっと撫でてくれてもいいんだぞ？」	「…可以再抚摸我一点吗？」
「ふふ、好きな人に撫でられるのって、とても気持ちがいいな…」	「fufu，被喜欢的人抚摸，感觉很舒服啊…」
「ん…」	「啾…~」
顔を離すと%ANAME(TARGET)%は恥ずかしそうに視線を逸らしてしまった	一离开脸，%ANAME(TARGET)%害羞地移开了视线
「んっ…大好きだぞ、%ANAME(MASTER)%♥」	「嗯…最喜欢你了，%ANAME(MASTER)%♥」
「もっと、…んん♥」	「更多…嗯~呜♥」
「…ん…こういうのも、ムードがあっていいな♥」	「…唔…这样的话、气氛不错呢♥」
「私の唇の味はどうだ？　ふふっ♥」	「我嘴唇的味道怎么样？ fufu♥」
「んっ…好きだぞ、%ANAME(MASTER)%♥」	「嗯…唔…我喜欢你，%ANAME(MASTER)%♥」
「ちゅ…なぁ…もっと…」	「啾…唔…再来…」
%ANAME(TARGET)%は頬を染め期待に満ちた目で%ANAME(MASTER)%を見つめた	%ANAME(TARGET)%红着脸颊用充满期待的眼神，凝视着%ANAME(MASTER)%
「ちゅ…ん…もっと…♥」	「啾…嗯…更多…♥」
%ANAME(TARGET)%は頬を染めながらせがんできた…	%ANAME(TARGET)%的脸颊被染红了…
「ん…ちゅ…ふふ…もっとか？」	「嗯…唔…fufu…继续么？」
「ちゅ…ん…もっと…」	「啾…唔……更多…」
「ちゅ…んっ…」	「唔…嗯…」
「んん…」	「嗯…」
「ちゅっ…愛してるぞ、%ANAME(MASTER)%♥」	「啾…唔…我爱你，%ANAME(MASTER)%♥」
「んん……大好きだぞ、%ANAME(MASTER)%♥」	「嗯…唔…最喜欢你了，%ANAME(MASTER)%♥」
「ちゅぅ……、なぁ…もっと…」	「嗯…唔…、啊…更多…」
「ちゅぅ…なぁ…もっと…」	「嗯…啊…还要…」
「んんぅ…ちゅぅ…れろ…♥」	「嗯…唔呣…来吧…♥」
%ANAME(TARGET)%は自ら舌を絡ませて%ANAME(MASTER)%の唾液を舐めとった	%ANAME(TARGET)%用舌头缠住着%ANAME(MASTER)%的舌吸吮着唾液
「んんぅ…ちゅぅ…れろ…」	「嗯…呣…来吧…」
「あむっ…ぢゅぅ…んはっ…愛してるぞ、%ANAME(MASTER)%♥」	「啊…唔…嗯呣哈…我爱你，%ANAME(MASTER)%♥」
「んんっ…は…くちゅ…ん…」	「啊…哈…啾…唔…」
%ANAME(TARGET)%と%ANAME(MASTER)%は涎が滴るのも構わず夢中で舌を絡ませあった	%ANAME(TARGET)%和%ANAME(MASTER)%顾不及口水的滴淌，忘我地交缠着舌头
「んぅ…れろ…ぢゅぅ…んはっ…もっと…」	「啊…哈啊…啾…唔…别停…」
%ANAME(TARGET)%はもう一度%ANAME(MASTER)%と舌を絡ませ唾液を貪り始めた	%ANAME(TARGET)%与%ANAME(MASTER)%舌头纠缠在一起，贪婪的吸吮着对方的唾液
「んんっ、ちゅぷ……れろ、ちゅ、んふっ…♥　もっと味わわせておくれ♥」	「啊…啾…，呣，嗯哼…♥ 再让我多尝尝♥」
二人は互いに激しく舌を絡め、唾液をそれぞれの口の中に流し込む作業に夢中になっている	两人互相激烈地交缠着舌头，埋头于将唾液注入对方口中的行为
「あむっ…ぢゅぅ…んはっ…大好きだぞ、%ANAME(MASTER)%♥」	「啊…啾…哈啊…最喜欢你了、%ANAME(MASTER)%♥」
「んぅ…れろ…ぢゅぅ…んはっ…もっと…♥」	「唔…嗯…啾……哈啊…更多…♥」
「んんっ、ちゅぷ……れろ、ちゅぅ……もっと…♥」	「嗯……呜，嗯…啾…再来…♥」
%ANAME(TARGET)%は%ANAME(MASTER)%の首に腕を絡め、更なるキスをせがんできた…	%ANAME(TARGET)%用手臂缠住%ANAME(MASTER)%の的脖子，要求进一步接吻…
「くちゅ…んん…ぷぁ…」	「呜…嗯…呣…」
二人の間に唾液の糸が出来ているのを見ると、%ANAME(TARGET)%は恥ずかしそうに顔を手で覆った	看到两个人之间结成的唾液丝，%ANAME(TARGET)%害羞地用手捂着脸
「んん！？　…んぅぅ…」	「嗯！？…呜呜…」
%ANAME(TARGET)%は舌を入れられたことに驚いたが、やがて%ANAME(MASTER)%の舌を受け入れた	%ANAME(TARGET)%对舌头的入侵而感到吃惊，不过不久就接受%ANAME(MASTER)%的舌头
「んんっ、ちゅぷ……れろ、ちゅ、んふっ…♥　もっと味わっておくれ♥」	「嗯……唔，呣，嗯哼…♥请再多尝一尝♥」
「背中、流そうか。ふふ、遠慮なんてしなくていいぞ♥」	「让我给你洗背吧。 fufu，不用客气啦♥」
「背中、流すぞ」	「擦背吧」
「ふふ、痒いところは無いか？　%ANAME(MASTER)%」	「fufu，没有痒的地方吗？%ANAME(MASTER)%」
「ごしごし…と。痛くないか？　%ANAME(MASTER)%」	「干巴巴的…这样不痛吗？%ANAME(MASTER)%」
「石鹸で泡立てて…手で優しく洗ってあげるからな」	「用肥皂起泡…我会用手温柔地洗的」
「背中、流してもらいたいのか？　ふふ、いいぞ♥　遠慮なんてしなくていいからな」	「你想让我给你洗背吗?fufu，好啊♥不用客气。」
「背中、流してもらいたいのか？」	「你想让我给你洗背吗?？」
「それじゃあ、流すぞ」	「那我洗了」
「今日はどこへ行く？　%ANAME(MASTER)%」	「今天去哪里？%ANAME(MASTER)%」
「どこへ行こうか…楽しみだな」	「去哪里好呢…好期待啊」
「今日はどこへ連れて行ってくれるんだ？　%ANAME(MASTER)%」	「今天带我去哪里？%ANAME(MASTER)%」
「どこへ行くのか…楽しみだ」	「要去哪里呢…好期待啊」
「私からもキモチよくしてやるからな♥」	「我会让你感觉舒服的♥」
「九尾の性技、とくと味わっておくれ♪」	「九尾的性技，请好好享受吧♪」
「ああ、%ANAME(対象)%の身体…、もっと触らせておくれ♥」	「啊啊，%ANAME(対象)%的身体…再让我多摸会♥」
「尻尾も合わせて、いっぱいキモチよくしてやるからな♥」	「尾巴也合在一起了，我会好好地让你舒服起来的♥」
「いつでもイっていいからな、我慢なんてしなくていいぞ♥」	「什么时候都可以哦、不用忍耐什么的♥」
「もっと蕩けて…私のモノになってしまえ♥」	「再放荡一点…成为我的东西吧♥」
「私の手、すべすべだろう？尻尾でもしてあげるぞ♥」	「我的手、很柔嫩吧？尾巴也一起哦♥」
「九尾のテクニック、堪能させてやろう♪」	「九尾的技巧，让我好好享受吧♪」
「蕩けさせてあげるからな♥」	「我会让你溶化的♥」
「私からもキモチよくしてあげるからな♥」	「我会让你感觉舒服的♥」
「ああ、%ANAME(対象)%♥　もっと触らせておくれ♥」	「啊、%ANAME(対象)%♥　再让我多摸会♥」
「こっちもキモチよくしてやるからな♥」	「我会给你无上的快乐的♥」
「ああ、%ANAME(対象)%のおっぱい、もっと触らせておくれ♥」	「啊啊，%ANAME(対象)%的胸部，再让我摸一下♥」
「指で乳首つまんで、先っぽを尻尾で…。ふふ、キモチいいだろう♥」	「用手指捏着乳头，用尾巴捏住前端…。fufu，感觉舒服吧♥」
「お前の胸も敏感にしてあげるな♥」	「你的胸部也要变得敏感了呢♥」
「さあ、もっと蕩けて…私のモノになってしまえ♥」	「来，再更加放荡…成为我的东西吧♥」
「私の指でクニクニされるの、いいだろう？　尻尾でもしてあげるぞ♥」	「我的手指舒服吗？来，尾巴也一块用上哦♥」
「私からもキモチよくしてあげる♥」	「我也会变的舒服起来的♥」
「ああ、%ANAME(対象)%のおっぱい、もっと感じさせてアゲル♥」	「啊啊，%ANAME(対象)%的胸部，再让我感受一下♥」
「指で乳首つまんで、先っぽを尻尾で…♥　ふふ、キモチいいか？」	「用手指捏着乳头，尖端用尾巴…♥呵呵，感觉舒服吗？」
「お尻の穴も気持ちよくしてあげるからな♥」	「屁股上的洞也会让你舒服的♥♥」
「こっちの穴も気持ちよくしてやろう」	「这个洞也给你快感吧」
「%ANAME(対象)%のここも、いっぱいキモチよくしてあげるからな♥」	「%ANAME(対象)%的这里、我也会给你无上的快感的♥♥」
「ちゃんとココもしてあげるぞ。私にお尻イジられるの、大好きだもんなぁ♥」	「我会给你好好做的。因为我喜欢欺负你的屁股呢♥」
「アナルでイカせてあげる♪　遠慮せずに喘いでいいぞ♥」	「肛门那会好好照顾的♪　不用顾虑，尽情地娇喘吧♥♥」
「もっと蕩けて…私のものになってしまえ♥」	「再放荡一点…成为我的东西吧♥」
「ここもキモチよくしてあげるからな…♥」	「这里也会让你舒服的…♥♥」
「お尻イジられるの、キモチいいか？　ならもっとしてやるぞ♥」	「被欺负屁股，感觉好吗？那么我再多欺负点♥」
「お尻で蕩けさせてあげるからな♥」	「我会让你屁股舒服得溶化的♥」
「こっちもキモチよくしてやろう」	「我也会好好做的」
「こっちも責めてやろう」	「这边会好好欺负你的」
「さあ、私の尻尾で女にしてやるぞ…♥」	「那么，用我的尾巴来做女人吧…♥」
「尻尾を入れてあげよう♥」	「把尾巴伸进去吧♥」
「ふふ…♥　キモチいいか？」	「fufu…♥感觉舒服吗？」
%ANAME(TARGET)%の尻尾が%ANAME(対象)%の雌穴を隙間無く犯している	%ANAME(TARGET)%的尾巴没有缝隙地侵犯了%ANAME(対象)%的母穴
毛先がまるでドリルのようになり、ずぽずぽと絶え間なく快感を与えてくる	发梢就像钻头一样，不断地给人带来快感
「あ、涎たれてるぞ…ちゅぅ…ふふ、そんなにキモチいいんだな♥」	「啊，流口水了啊……嗯…fufu，这么舒服的嘛♥」
「ふふ…♥　お前の穴と私の尻尾、とても相性がいいみたいだ♥　嬉しいよ♥」	「fufu…♥　你的洞和我的尾巴，好像很投缘♥ 好开心啊♥」
%ANAME(TARGET)%の尻尾は時折肉棒のような形状に変化しながら%ANAME(対象)%の雌穴を犯している	%ANAME(TARGET)%的尾巴变成肉棒一样的形状，侵犯着%ANAME(対象)%的小穴
「お前が大好きな尻尾でたっぷり犯してやるからな。ふふ♥」	「我会用你最喜欢的尾巴充分地侵犯你的。fufu♥」
%ANAME(対象)%は秘裂を分け入って膣内を責め立てる尻尾の快楽に蕩けている	%ANAME(対象)%分开秘裂让尾巴钻入阴道内，沉醉在尾巴的快乐中
「あぁ♥　私の尻尾がそんなにキモチいいんだな♥　いくらでもよがっていいぞ♪」	「啊啊♥我的尾巴那么舒服啊♥无论多少都可以哦♪」
「あ♥　身体ビクビクしてる♥　尻尾で犯されるの、もう病みつきみたいだな♥」	「啊♥身体战战兢兢♥被尾巴侵犯着，好像已经上瘾了♥」
%ANAME(TARGET)%は%ANAME(対象)%の女陰を尻尾で責め立て、相手を犯す快感に酔っている	%ANAME(TARGET)%用尾巴责备%ANAME(対象)%的小穴，陶醉于侵犯对方的快感
%ANAME(TARGET)%の尻尾が%ANAME(対象)%の蜜壷を容赦なく責め立てる	%ANAME(TARGET)%的尾巴毫不留情地责备%ANAME(対象)%的蜜壶
「ふふふ…♥　もっといっぱい声出していいんだぞ♥」	「fufufu…♥　可以叫出声哦，再大声点也行哦♥」
%ANAME(TARGET)%は%ANAME(対象)%の雌穴に一本の尻尾を出し入れしつつ他の尻尾で全身を責め立てている	%ANAME(TARGET)%在%ANAME(対象)%的小穴用一根尾巴抽插着，并用其他尾巴爱抚着身体
「私の尻尾で犯される気分はどうだ？」	「被我的尾巴侵犯的感觉怎么样？」
「ふふ、いくらでもよがっていいからな♥」	「fufu，不管多少都可以哦♥」
「尻尾で犯してあげよう」	「用尾巴来侵犯你吧」
「あぁ♥　私の尻尾がそんなにキモチいいんだな♥　いくらでもよがっていいんだぞ♪」	「啊啊♥我的尾巴那么舒服啊♥无论多少都可以哦♪」
「さあ、見て…私の尻尾がお前に入っていくぞ…♥」	「来，看看…我的尾巴会进入你的身体…♥」
%ANAME(TARGET)%の尻尾が%ANAME(対象)%の尻穴を隙間無く犯している	%ANAME(TARGET)%的尾巴在%ANAME(対象)%的屁股上无缝隙地侵犯着
「あ、涎たれてるぞ。…ちゅぅ…ふふ、そんなにキモチいいんだな♥」	「啊，流口水了。…嗯…呵呵，感觉这么舒服啊♥」
「ふふ…♥　ココを責められると弱いみたいだな。可愛い声が出てるぞ♥」	「呵呵…♥被责备这里的话好像很弱呢。发出了可爱的声音♥」
%ANAME(TARGET)%は%ANAME(対象)%の尻穴に無数の尻尾を出し入れしつつ、腸壁を毛先で刺激してくる	%ANAME(TARGET)%在%ANAME(対象)%的屁股孔里抽插着无数的尾巴，用发梢刺激肠壁
「ああ、本当にイイ声だ…。もっと九尾を味わってくれ♥」	「啊啊，真是好声音啊…。再好好享受下九尾的魅力吧♥」
%ANAME(対象)%はアナルを責め立てる、蕩けるような快感に悶えている	%ANAME(対象)%渴求着肛交，在放荡的快感中挣扎着
%ANAME(TARGET)%の尻尾は時折肉棒のような形状に変化しながら、ゴリゴリと%ANAME(対象)%の尻穴を犯している	%ANAME(TARGET)%的尾巴变成肉棒一样的形状，侵犯着%ANAME(対象)%的屁穴
「あ♥　こっちもビクビクしてる♥　尻尾でアナル責められるの、もう病みつきみたいだな♥」	「啊啊♥身体在兴奋地颤抖呢♥ 被尾巴欺负肛门，好像已经上瘾了呢♥」
%ANAME(TARGET)%は%ANAME(対象)%の尻穴を尻尾で犯しつつ、射精の時を待ちわびている…	%ANAME(TARGET)%将%ANAME(対象)%的屁穴用尾巴责备着、等待着射精的时刻
%ANAME(TARGET)%の尻尾が%ANAME(対象)%の尻穴を容赦なく責め立てる	%ANAME(TARGET)%的尾巴毫不留情地责备%ANAME(対象)%的屁穴
「ふふふ…♥　可愛い声が出てるぞ♥」	「fufu…♥　发出了女孩子般的声音呢♥」
%ANAME(TARGET)%は%ANAME(対象)%の尻穴に一本の尻尾を出し入れしつつ他の尻尾で下半身を責め立てている	%ANAME(TARGET)%在%ANAME(対象)%的屁股孔里用一只尾巴抽插着，其他尾巴爱抚着下半身
「ん…こっちもビクビクしてる♥　アナル責められるの、そんなにいいんだな♥」	「啊…身体在兴奋地颤抖呢♥　肛门被欺负、这么舒服吗♥」
%ANAME(TARGET)%は尻穴を尻尾で犯しつつ、%ANAME(対象)%の射精の時を待っている…	%ANAME(TARGET)%一边用尾巴欺负着屁股孔，一边等待着%ANAME(対象)%射精的时候
「尻尾で責めてあげよう」	「用尾巴来侵犯你吧」
「さあ、見て…私の尻尾がお前に入っていくところを…♥」	「来，看吧…我的尾巴正要进入你的地方…♥」
「あぁ♥　私の尻尾がそんなにキモチいいんだな♥　いくらでもよがっていいからな♪」	「啊啊♥我的尾巴那么舒服啊♥无论多少都可以去哦♪」
「ふふ、いただくぞ♥　んんっ…♥…れろ…♥」	「fufu、我要吃了哦♥　嗯…♥…啊呜…♥」
「んんっじゅぷっ…」	「啊呜…呣」
「ん…♥…ちゅぶ…♥　ちゅぅ…ちゅぷ…っ♥」	「嗯…♥…啾…♥　嗯…啾…嗯♥」
「%ANAME(MASTER)%の、もう病みつきだよ…♥♥」	「%ANAME(MASTER)%的、已经上瘾了…♥♥」
%ANAME(TARGET)%はまるで飴でも舐めるかのようにしゃぶりつき、%ANAME(MASTER)%の絶頂へ誘う…	%ANAME(TARGET)%就像舔糖一样，紧紧地吸着，让%ANAME(MASTER)%走向绝顶…
「んんっ♥じゅぷっ…れろ…♥　いくらでも飲んであげるから、たっぷり出していいぞ♥」	「嗯♥...啾…噗…♥ 多少都给你喝下去哦、满满的射出来吧~♥」
「どうしてこんなに愛おしく感じるのだろう…♥」	「啊…露出可爱的表情了呢♥」
%ANAME(TARGET)%はうっとりした表情でペニスを咥えると、のど奥まで一気にグラインドさせていく…	%ANAME(TARGET)%用出神的表情叼着肉棒，一口气让它滑到喉咙深处……
「ん…♥ちゅ…♥れろ…　私の口まんこに、いっぱい出してくれ♥♥」	「嗯…♥啾…♥呜…　在我的嘴里...满满的射出来吧	♥♥」
%ANAME(TARGET)%はペニスの鈴口をチロチロと舌で刺激し、%ANAME(MASTER)%の射精を待ちわびている…	%ANAME(TARGET)%用舌头刺激着马眼、催促着%ANAME(MASTER)%射精…
「んんっ♥じゅぷっ…れろ…♥　%ANAME(MASTER)%の…とっても美味しい…♥」	「嗯...♥啾…呜…♥　%ANAME(MASTER)%的…非常好吃呢…♥」
「あん…じゅる♥…ちゅっ♥…♥　我慢汁だけじゃ物足りないな♥」	「啊呜…啾♥…啾♥…♥　光是忍耐汁还不够啊♥」
「んんっ♥じゅぷっ…れろ…♥　早く濃いの、出してくれ♥」	「嗯啊♥啾…呣♥　快点把浓浓的精液、射出来~♥」
「ん…♥じゅ…♥…いっぱい出していいぞ♥」	「嗯…♥啾…♥呜…再多射点出来♥」
「ふふ、それでは…♥　んんっ…♥…れろ…♥」	「fufu、那么...♥　嗯…♥…啊呜…♥」
「おっぱいでしてほしい？　…ふふ、そうだな…私のコレにあれだけ目が行ってたんだもんなぁ…♥」	「你想让我用你的胸部做吗？…行呀…这么期待着嘛…呼呼♥」
%ANAME(TARGET)%はしっかりと両手で谷間を作り、陰茎を包み込むようにして谷間に導いた…	%ANAME(TARGET)%用双手紧紧地裹着胸部，将阴茎包裹起来，引导到山谷中……
その中は外見の張りのあるイメージとは裏腹にまるで羽毛布団にくるまったような温もりと柔らかさであった…	在里面感觉与外表有张力的印象相反，简直就像裹在羽毛被子里一样的温暖和柔软……
%ANAME(TARGET)%の気持ちいいか？　という問いに全力で頭を上下に振ると、%ANAME(TARGET)%も満足そうな顔で微笑んだ	%ANAME(TARGET)%问我舒服吗？ 对于这个问题我全力地点着头，%ANAME(TARGET)%带着满足的表情上下涌动着胸爱抚着肉棒…
「おっぱいで？　…ふふ、そうだな…私のコレにあれだけ目が行ってたんだもんな…」	「用乳房？…呼呼、行啊…对我的胸部这么在意吗…」
「%ANAME(MASTER)%は本当におっぱいが好きだな…。だが、悪い気はしないよ♥」	「%ANAME(MASTER)%真的很喜欢胸部啊…。啊、抱歉，我没有恶意哦♥」
「愛する人が、私の身体で感じてる顔を見るというのは何とも幸せなものだ…♥」	「看到所爱之人用我的身体舒服起来的样子，真是幸福啊……♥」
そう言うと、%ANAME(TARGET)%は谷間を作り、そのままペニスを突きいれるように促している…	%ANAME(TARGET)%这么说道，扶着胸部，催促直接将肉棒刺入……
「どうだ？　膣にも負けないほどキモチいいだろう？　ふふ♥」	「fufu♥怎么样？舒服程度不输于小穴吧？♥」
余りの快感にその問いに応られず、%ANAME(MASTER)%は谷間にペニスを一心不乱に打ちつけている	%ANAME(MASTER)%因过于快感而无法回答那个问题，在山谷里专心地耸动着肉棒
%ANAME(TARGET)%も乳房を寄せ、乳首を陰茎にこすりつけるように動かし、%ANAME(MASTER)%を快感で支配していく…	%ANAME(TARGET)%也把乳房夹紧，把乳头摩擦到阴茎上，%ANAME(MASTER)%被快感支配着…
「こうやってペニスを挟んでいると、私もこの熱で凄く興奮するんだ…♥」	「像这样夹着肉棒的话，我也会因为这热热的肉棒而兴奋的……♥」
「%ANAME(MASTER)%のペニスが跳ねるたびに、私の胸で感じてくれている…という証なのだからな♥」	「%ANAME(MASTER)%の每次肉棒跳跃的时候，我都会在胸口感受到…这就是夫君舒服的证明~♥」
そう言うと%ANAME(TARGET)%は更に胸でペニスをこすり上げると、はみ出た亀頭の鈴口に舌を差し入れるようにして刺激している…	%ANAME(TARGET)%这么说着，更是用胸摩擦着肉棒，并伸出舌头刺激着马眼…
%ANAME(TARGET)%は豊満な胸でむにむにと、%ANAME(MASTER)%の肉棒を弄んでいる	%ANAME(TARGET)%用丰满的胸脯咕噜咕噜地责弄着%ANAME(MASTER)%的肉棒
「ふふ…遠慮なく出していいぞ♥　私もお前の精がいっぱい欲しいから…♥」	「fufu…不用忍耐，尽情地射出来吧。♥　我也想要更多你的精液...♥」
そう言うと%ANAME(TARGET)%はスパートをかけ、%ANAME(MASTER)%は内からこみ上げてくる奔流を感じていた…	%ANAME(TARGET)%这么说着加快了摩擦肉棒，%ANAME(MASTER)%射精欲喷涌而出…
「お前も好きだな…だが、悪い気はしないよ♥」	「你就这么喜欢啊…啊、抱歉，我没有恶意哦♥」
「好きな人の感じてる顔を見るのは何とも愛おしいものだ…♥」	「看到喜欢的人舒服的样子，真是开心啊…♥」
「どうだ…？　まるで膣に入れているように感じるだろう？」	「怎么样…？感觉就跟插入小穴一样吧？」
「こうやってペニスを挟んでいると私もこの感触で…興奮するんだ…♥」	「这样夹着肉棒的话，我也会有感觉的…♥」
「%ANAME(MASTER)%のペニスが跳ねるたびに、私の胸で感じてくれている…という証なのだからな」	「每次%ANAME(MASTER)%的阴茎跳动的时候，都在我的胸口感受到…这就是证明」
「ふふ…♥　遠慮なく出していいぞ……♥」	「fufu…♥　不要顾虑地射出来吧……♥」
「どうだ？　私の胸は…柔らかいだろう…」	「怎么样？我的胸部…很柔软吧…」
「ふふ、病みつきって顔してるな。だが悪い気はしない…ちゅっ」	「fufu、你一副贪恋的样子啊。啊、抱歉，我没有恶意哦」
%ANAME(TARGET)%の顔が上気している。どうやら感じてくれていることに興奮を覚えているようだ	%ANAME(TARGET)%的嘴角微微上扬，似乎因为你的表现而兴奋
「さて、では私の媚肉と太股の柔らかさを味わってもらおうか」	「那么，好好享受我小穴和大腿的柔软吧」
%ANAME(MASTER)%の滾った肉棒を、%ANAME(TARGET)%は挿入せずに柔肉で挟み込む	%ANAME(MASTER)%的肉棒并没有插入小穴而是放进了%ANAME(TARGET)%温软的股间
「ふふ…。私の柔らかさ、存分に味わってくれ♥」	「fufu…。请尽情享受吧♥」
「あっ……んん」	「啊……嗯」
「お前のチンポと、あんっ♥　私のクリがキスするたびに、電撃が走ったみたいに…気持ちいいぃぃっ♥♥」	「你的肉棒，啊...♥　每次和我那里接吻时、就像是触电了一样…好舒服啊♥♥」
%ANAME(TARGET)%はその身を悶えさせるほどの快楽を貪ろうと、さらに腰を動かしている	%ANAME(TARGET)%的身体为了获取更大快乐，自然地配合着动着腰
「ああ…♥　我慢できない…次は、次は中でこれを…味わわせてくれ…♥」	「啊啊…♥　忍不住了啊…接下来、等会放进来行吗…让我尝尝吧…♥」
快楽に蕩けきった顔で懇願する%ANAME(TARGET)%の姿に、%ANAME(MASTER)%は肉棒を更に硬くさせた…	以沉醉于快乐的脸恳求着的%ANAME(TARGET)%的姿态、使%ANAME(MASTER)%肉棒更硬了…
「入れないのに何でこんなに気持ちがいいんだろうな…」	「为什么没放进去就这么舒服呢…嗯♥」
「こうやって亀頭が擦れるだけで…気持ちが、あっ♥　いい、あんっ！」	「像这样龟头摩擦就……好舒服，啊♥ 唔...嗯！」
「擦るだけで満足できるのか…？」	「只是摩擦一下就能满足了吗…？」
「え？　これはこれでいいものだって？　…そういうものか…」	「诶？这样舒服吗？…是这样吗…」
%ANAME(TARGET)%はそう言うとその太股でも陰茎を擦り上げ始めた…	%ANAME(TARGET)%说道，然后用大腿摩擦着肉棒…
「お前の、ソレと、私のココを擦りつけるのか…」	「你的...那个...要在我的那里摩擦吗…」
まだ慣れない様子の%ANAME(TARGET)%。%ANAME(MASTER)%は自分で亀頭を淫核の元へと持っていくと軽くつついてみた…	%ANAME(TARGET)%看起来还不习惯的样子。%ANAME(MASTER)%用自己的龟头轻抚着阴蒂…
「ふあああっ！　そこは…感じ過ぎてしまう…」	「啊...额嗯！那里…嗯....太敏感了啊…」
「お前のチンポと、あんっ♥　私のクリがキスするたびに、電撃が走ったみたいに…気持ちいいぃぃっ！♥♥」	「你的肉棒，啊...♥　每次和我那里接吻时、就像是触电了一样…好舒服啊♥♥」
%ANAME(TARGET)%は奉仕するのも忘れてその快楽に身を悶え続けている	%ANAME(TARGET)%忘了侍奉，沉浸在快感之中
「私の脚で、キモチよくしてやろう♥」	「用我的脚、让你变得舒服吧♥」
「脚でシてやろう」	「用脚来做吧」
「ふふ…♥　こっちも見てみるか？」	「fufu…♥　这边也要看看嘛？」
%ANAME(TARGET)%は足コキ中、%ANAME(MASTER)%に自らの秘所を中まで見えるよう開帳している	%ANAME(TARGET)%用脚爱抚着肉棒，为了能让%ANAME(MASTER)%看见自己的秘处而张开了腿
「ああ♥　すごい視線を感じるぞ♥」	「啊啊♥　能感受到炙热的视线呢♥」
「私の脚でキモチよくしてあげるからな♥　どうだ？%ANAME(MASTER)%♥」	「我的脚真的有那么舒服吗♥　感觉怎么样？%ANAME(MASTER)%♥」
%ANAME(TARGET)%のすべすべの美脚が%ANAME(MASTER)%の肉棒に快感を与えていく…	%ANAME(TARGET)%柔若无骨的脚丫给%ANAME(MASTER)%的肉棒带来着无比的快感…
「痛かったらすぐに言ってくれよ？　痛いよりキモチよくなってほしいからな…♥」	「痛的话马上告诉我吧？　比起疼痛更希望你感觉舒服呢…♥」
%ANAME(TARGET)%のすべすべの足裏が%ANAME(MASTER)%の肉棒を優しく挟み、擦りあげていく	%ANAME(TARGET)%用光滑的脚丫包裹着%ANAME(MASTER)%的肉棒、温柔地摩擦着
「ああ♥　足にお前の熱を感じて…私もキモチいいぞ…♥」	「啊啊♥　能从脚上感觉到你的热度呢…我也舒服哦…♥」
「ふふ…♥　どこを見ているんだ？」	「fufu…♥　你在看哪呢？」
%ANAME(MASTER)%は足コキで丸見えになった%ANAME(TARGET)%の秘所に目を奪われている	%ANAME(MASTER)%被足交后变得湿润的%ANAME(TARGET)%的秘处夺走了目光
「脚の綺麗さには自信があるぞ、どうだ？　%ANAME(MASTER)%♥」	「我对脚还是很有自信的哦，感觉怎么样？%ANAME(MASTER)%♥」
%ANAME(TARGET)%のすべすべの美脚が%ANAME(MASTER)%の肉棒を捉える	%ANAME(TARGET)%用光滑的脚丫抓住了%ANAME(MASTER)%的肉棒
「痛かったら言っておくれ？　痛いよりキモチよくなってほしいからな…♥」	「痛的话马上告诉我吧？　比起疼痛更希望你感觉舒服呢…♥」
「脚でシてほしいって？」	「你说要用脚来做？」
「ふふ…♥　こっちも見てみたいか？」	「fufu…♥　这边也要看看嘛？」
「ああ♥　すごい視線を感じる♥」	「啊啊♥　能感受到炙热的视线呢♥」
「私の脚でキモチよくしてあげるからな♥　どうだ？　%ANAME(MASTER)%♥」	「我的脚真的有那么舒服吗♥　感觉怎么样？%ANAME(MASTER)%♥」
%ANAME(TARGET)%のすべすべの足裏が%ANAME(MASTER)%の肉棒を挟み、擦りあげていく	%ANAME(TARGET)%用光滑的脚丫包裹着%ANAME(MASTER)%的肉棒、温柔地摩擦着
「ふふ…♥　尻尾でも相手してやるぞ」	「fufu…♥　连尾巴也一块上哦」
「尻でもシゴいてほしいのか？」	「想用臀部做？」
「ふふ…♥　尻尾も一緒に楽しんでおくれ♥」	「fufu…♥　尾巴也一块享受吧♥」
%ANAME(TARGET)%は尻で肉棒を捉えながら、尻尾で%ANAME(MASTER)%の全身を撫でるように愛撫している	%ANAME(TARGET)%一边用臀部夹住肉棒一边用尾巴抚摸着%ANAME(MASTER)%的全身
%ANAME(TARGET)%が尻コキをする中、%ANAME(MASTER)%は目の前でゆさゆさ揺れる尻尾に魅せられて思わず飛びついた	%ANAME(TARGET)%用臀部摩擦着肉棒时，%ANAME(MASTER)%被摇摆不定的尾巴所吸引，不由自主地将脸埋了进去
ふかふかの尻尾に顔をうずめて深呼吸すると、脳を蕩かすようなとてもいい匂いがする…	把脸埋在蓬松的尾巴上吸的话，就闻到一股让人头脑发热的香味……
「ひゃん♥　もう、そんなにされたらちょっと恥ずかしいぞ…♥」	「啊啦♥　真是的，那样做的话有点不好意思啊…♥」
「私のお尻、柔らかいだろう？　尻尾も存分に触っていいからな♥」	「我的屁股很柔软吧？尾巴也可以尽情地抚摸哦♥」
%ANAME(TARGET)%は肉棒を尻で挟みつつ、尻尾を%ANAME(MASTER)%の全身に絡みつかせている	%ANAME(TARGET)%用臀部夹住肉棒，尾巴缠绕在%ANAME(MASTER)%的全身
%ANAME(TARGET)%は尻で肉棒を捉えながら、尻尾で%ANAME(MASTER)%の身体を愛撫している	%ANAME(TARGET)%一边用臀部夹住肉棒一边用尾巴爱抚着%ANAME(MASTER)%的身体
%ANAME(TARGET)%が尻コキをする中、%ANAME(MASTER)%は目の前でゆさゆさ揺れる尻尾を思わず抱きしめた	%ANAME(TARGET)%臀交时、%ANAME(MASTER)%不由地抱住了眼前摇摆不定的尾巴
「ひゃぁ♥　もう、そんなに尻尾が気になるか？　%ANAME(MASTER)%♥」	「啊啦♥　已经这么在意尾巴了吗？　%ANAME(MASTER)%♥」
「お尻も柔らかいだろう？　尻尾も触っていいぞ♥」	「我的屁股很柔软吧？尾巴也可以尽情地抚摸哦♥」
「尻でもシゴいてやろう」	「要用臀部舒服起来啊」
「たまにはこういう趣向もいいだろう？」	「偶尔这样做也蛮有趣的嘛？」
「コレでしてやろう」	「就用这个吧」
「こういうのもキモチいいだろう？　…まあ、私の中の方がずっとキモチいいはずだけどな」	「这样也很舒服吧？　…嘛，我心里也很愉悦哦」
%ANAME(TARGET)%はオナホの快感に悶える%ANAME(MASTER)%の姿を面白そうに眺めている	%ANAME(TARGET)%饶有兴致地看着沉浸于飞机杯快感中的%ANAME(MASTER)%的样子
「……私よりこっちがいいのか？」	「……比我这边更好吗？」
%ANAME(TARGET)%は不満気に頬を膨らませている	%ANAME(TARGET)%不满地嘟着脸
「これがいいのか？」	「这样舒服吗？」
「絶対私の方がキモチいいのに…」	「我肯定比这好…」
「九尾の尻尾で奉仕されるなんて、幸せ者だぞ？　お前は♥」	「你啊...能让九尾用尾巴服务，真是幸福的人啊？♥♥」
「九尾の尻尾、存分に味わうと良い」	「九尾的尾巴，好好享受吧」
%ANAME(TARGET)%の尻尾が%ANAME(MASTER)%の肉棒をくまなく包んで愛撫している	%ANAME(TARGET)%用尾巴把%ANAME(MASTER)%的肉棒包裹得紧紧的，爱抚着
毛先がまるで筆のように、カリ首や鈴口を的確になぞって刺激し極上の快感を与えてくる	尾巴的发梢就像笔尖一样，精准地描绘着龟头和马眼，刺激着它们，给予着无上的快感
「あ、涎たれてるぞ。…ちゅぅ…♥　ふふ、そんなにキモチいいんだな♥」	「啊、都流口水了…嗯…fufu、有这么舒服嘛♥」
「ふふふ…♥　ココを責められると弱いみたいだな♥」	「呵呵…♥　捉弄这里的话看起来很敏感嘛♥」
%ANAME(TARGET)%はペニスの鈴口をチロチロと尻尾で刺激し、%ANAME(MASTER)%の射精を待ちわびている…	%ANAME(TARGET)%刺激着肉棒的马眼，期待着%ANAME(MASTER)%射精…
「先走りがどんどん出てくるな♥　もっと尻尾でキモチよくなってくれ♥」	「不要急着出来哦♥　再多感受一下尾巴的魅力吧♥」
「私の尻尾でシゴかれるの、どうだ？　毎日手入れしているから綺麗だろう？　ふふ♥」	「被我的尾巴轻抚着，感觉如何？　因为每天都在保养所以很漂亮吧？fufu♥」
%ANAME(MASTER)%はペニスを包み込む感触が与える天国のような快感に悶えている	%ANAME(MASTER)%因为包裹肉棒的触感带来的天堂般的快感而失神
「あぁ、そんなにキモチいいんだな♥　もっとよがっていいんだぞ♪」	「啊啦♥这么舒服嘛♥ 那么...再多做点好了♪	」
「ふふ…♥　お前のコレと私の尻尾、とても相性がいいみたいだな…♥」	「fufu…♥　你的那个和我的尾巴、相性好像不错呢…♥」
%ANAME(TARGET)%の尻尾は肉棒を極上の感触で包み込み、%ANAME(MASTER)%の射精の時を待ちわびている…	%ANAME(TARGET)%的尾巴用极上的触觉包住肉棒、期待着%ANAME(MASTER)%射精的那一刻…
「ふふ…♥　私の尻尾でキモチよくなってくれると、とても嬉しいよ♥」	「fufu…♥　如果能用我的尾巴变舒服的话，我也会很开心的♥」
%ANAME(TARGET)%の尻尾は毛先がまるで筆のようになってカリ首や鈴口を刺激し、%ANAME(MASTER)%を射精へ導いていく	%ANAME(TARGET)% 尾巴的发梢就像笔一样，刺激着龟头和马眼、引导着%ANAME(MASTER)%射精
「私の尻尾でシゴかれるの、どうだ？」	「被我的尾巴轻抚着，感觉如何？」
「毎日手入れしているから綺麗だろう？　ふふ♥」	「因为每天都在保养所以很漂亮吧？fufu♥」
「ん…♥　お前のコレ、とても熱いな…♥」	「嗯…♥你的这个、好烫啊…♥」
%ANAME(TARGET)%は肉棒を尻尾で包み込み、%ANAME(MASTER)%の射精の時を待っている…	%ANAME(TARGET)%用尾巴包住肉棒，等待%ANAME(MASTER)%の射精的那一刻...
「九尾の尻尾で奉仕させるなんて、大した男だよ%ANAME(MASTER)%は♥」	「竟然用九尾的尾巴来服务，真是个了不起的男人啊！%ANAME(MASTER)%桑♥」
毛先がまるで筆のように、カリ首や鈴口を的確に刺激し極上の快感を与えてくる	尾巴的发梢就像笔尖一样，准确地描绘着龟头和马眼，刺激着它们，给予着无上的快感
「先走りがどんどん出てくるな♥　もっと尻尾を味わっておくれ♥」	「不要急着出来哦♥　再多感受一下九尾的魅力吧♥」
「私の尻尾でシコかれるの、どうだ？　毎日手入れしているから綺麗だろう？　ふふ♥」	「被我的尾巴轻抚着，感觉如何？　因为每天都在保养所以很漂亮吧？fufu♥」
%ANAME(TARGET)%の尻尾は毛先がまるで筆のようにカリ首や鈴口を刺激し、%ANAME(MASTER)%を射精へ導いていく	%ANAME(TARGET)% 尾巴的发梢就像笔一样，刺激着龟头和马眼、引导着%ANAME(MASTER)%射精
「さあ、コレで…もっとキモチよくなろうな♥」	「那么，用这个……会变得更舒服吧♥」
「こういうのはどうだろう♥」	「这样的话，如何？♥」
「式が剥がれないかって？　これくらいの対策は万全さ」	「式符会不会被剥去？这种程度的对策已经是完美了」
「尻尾、触りたくないか？　%ANAME(MASTER)%になら許すぞ」	「尾巴，不想摸吗？如果是%ANAME(MASTER)%的话就允许你」
「親交を深めるにはこういう事も必要だよな」	「为了加深友谊，这样的事也是有必要的吧」
「まぁ、親交を深めるにはこういう事も必要ですよね」	「嘛，为了加深友谊这种事也是有必要的吧」
「ふふ♥　私の尻尾、いい毛並みだろう？　これで顔、いっぱい撫でてあげるからな♪」	「fufu♥ 我的尾巴漂亮吧？ 用这个，我会好好摸摸你的脸的♪」
「%ANAME(MASTER)%の身体、温かいな…。私の身体はどうか、確かめておくれ♥」	「%ANAME(MASTER)%的身体，好温暖啊…。我的身体怎么样么，自行确认一下吧♥」
%ANAME(TARGET)%は自慢の尻尾で%ANAME(MASTER)%の顔をさわさわと撫でるように弄んでいる	%ANAME(TARGET)%用自己引以为豪的尾巴轻抚着%ANAME(MASTER)%的脸
%ANAME(TARGET)%は%ANAME(MASTER)%に尻尾を絡めながら、柔らかな肢体を押し当ててくる	%ANAME(TARGET)%一边用尾巴缠着%ANAME(MASTER)%，一边用柔软的身体压了过来
「ふふ♥　…%ANAME(MASTER)%ったら顔が緩んでいるぞ。私の身体と尻尾、どちらが良いのかな♥」	「fufu♥　…%ANAME(MASTER)%的脸变得放松了呢。我的身体和尾巴，哪个更好呢♥」
「私の自慢の尻尾、是非とも堪能していってくれ♥」	「我引以为傲的尾巴，可要好好享受一番啊♥」
「私の尻尾でくすぐられるの、嬉しそうだな%ANAME(MASTER)%は♥」	「被我的尾巴挠着，看起来很开心啊%ANAME(MASTER)%♥」
%ANAME(TARGET)%はふさふさの尻尾で%ANAME(MASTER)%の身体を愛撫するように撫で回して来る	%ANAME(TARGET)%用毛茸茸的尾巴来回抚摸着%ANAME(MASTER)%的身体
「ああ、そんなに気持ち良さそうな顔しちゃったら、私もソノ気になってしまいそうだよ♥」	「啊啊，露出这么舒服的表情的话，我也会兴奋起来的♥」
「%ANAME(MASTER)%、膝枕してほしくないか？　遠慮せずにほら、おいで♥」	「%ANAME(MASTER)%，你不想枕在我膝盖上吗？ 别客气，来吧♥」
「……ふふ、気持ちよさそうな顔しちゃって。%ANAME(MASTER)%は本当に可愛いなぁ♥」	「……fufu，一脸舒服的样子。%ANAME(MASTER)%真可爱啊♥」
「%ANAME(MASTER)%、疲れてないか？　良かったら私がマッサージするぞ」	「你不累吗？如果累的话我给你按摩」
%ANAME(TARGET)%はうつ伏せになった%ANAME(MASTER)%に跨り、絶妙な力加減で筋を揉み解していく	%ANAME(TARGET)%跨过趴着的%ANAME(MASTER)%，以绝妙的力道揉解着肌肉
「さあ、リラックスして…私に全てを委ねてくれ…♥」	「来，放松一下吧…把一切都交给我吧…♥」
しなやかな指から送られる心地よい快感に、%ANAME(MASTER)%は涎を垂らすほど癒された…	被从柔软的手指送来的愉快的快感治愈了，%ANAME(MASTER)%舒服地流下了口水…
「ふふ、好きにしていいぞ…♥」	「fufu，随你喜欢吧…♥」
「手を繋いでいいか？　そう、こうやって指を絡めて…♥」	「想要牵手吗？好啊，像这样十指相绕…♥」
「ふふ、いい顔だ…。もっと堪能しておくれ♥」	「fufu，一脸舒服的样子…请尽情享受吧♥」
%ANAME(TARGET)%は%ANAME(MASTER)%に寄り添い、肩に頭を預けている	%ANAME(TARGET)%贴近%ANAME(MASTER)%，将头托在肩上
「…%ANAME(MASTER)%の体、たくましく感じるよ…。もう少しこのままで…♥」	「…%ANAME(MASTER)%的身体，感觉很宽厚呢…。就这样待会吧…♥」
「%ANAME(MASTER)%、尻尾に入ってみたくないか？　…ふふ♥　どうだ？」	「%ANAME(MASTER)%、不想钻进尾巴里吗？　…fufu♥怎么样？」
%ANAME(TARGET)%は%ANAME(MASTER)%にふわふわの尻尾を向けている	%ANAME(TARGET)%把软绵绵的尾巴朝向%ANAME(MASTER)%
貴方ならどうする？　最高だった	你会怎么做呢？感觉非常棒哦
「%ANAME(MASTER)%、疲れた顔しているぞ。良かったら私がマッサージでもしようか？」	「%ANAME(MASTER)%，你一脸疲惫的样子。如果可以的话，我来做按摩吧？」
「……ふふ♥　ああ、遠慮するな。さあ、リラックスしてくれ…」	「……fufu♥ 撒，别客气。来，放松一下吧…」
%ANAME(TARGET)%は%ANAME(MASTER)%の肩を優しく揉み込み、マッサージを始めた	%ANAME(TARGET)%温柔地揉搓着%ANAME(MASTER)%的肩膀，开始按摩
「%ANAME(MASTER)%って…結構たくましい腕をしているんだな」	「%ANAME(MASTER)%桑…你的手臂真是结实啊」
「へんな所は触らないから安心しておくれ」	「不会碰奇怪的地方的，请放心」
「少し、手を見せてもらってもいいか？」	「可以让我看看你的手吗？」
「お体に触りますよ…」	「让我来摸你的身体…」
「へんな所は触りませんので…」	「奇怪的地方我不会碰的…」
「少し、手を見せてもらってもよろしいですか？」	「可以让我看看你的手吗？」
「尻尾を触ってみたくないか？　%ANAME(MASTER)%になら…いいぞ♪」	「不想摸一下尾巴吗？如果是%ANAME(MASTER)%的话…可以哟♪」
「親交を深めるにはこういう事も必要…なのか？」	「为了加深友谊，这样的事也是必要的…吗？」
「まぁ、親交を深めるにはこういう事も必要…ですよね？」	「嘛，为了加深友谊这种事也是必要的…是吧？」
「ふふ♥　私の尻尾、いい毛並みだろう？　もっといっぱい撫でておくれ♪」	「fufu♥ 我的尾巴包养得很好吧？再多抚摸一点吧♪」
「%ANAME(MASTER)%の身体、温かい…。私の身体はどうか、確かめておくれ♥」	「%ANAME(MASTER)%的身体，温暖的…。请确认我的身体怎么样♥」
%ANAME(TARGET)%は自慢の尻尾で%ANAME(MASTER)%の顔をさわさわと撫でている	%ANAME(TARGET)%用自己引以为豪的尾巴抚摸着%ANAME(MASTER)%的脸
「ふふ♥　蕩けた良い顔だ…そんなに私の尻尾が好きか？　じゃあもっとしてあげるからな♥」	「fufu♥ 一脸舒服的样子…你那么喜欢我的尾巴吗？那我再给你做一点吧♥」
「ふふ♥　…%ANAME(MASTER)%ったら顔が緩んでいるぞ。私の身体と尻尾、どちらが良いのかな？」	「fufu♥　…%ANAME(MASTER)%的连都放松了下来呢。我的身体和尾巴，哪个好呢？」
「…%ANAME(MASTER)%、なんだか疲れた顔つきをしているぞ？　少し休んでいくといい。ほら、ここに頭を乗せて」	「…%ANAME(MASTER)%，总觉得脸上露出疲惫的表情啊？稍微休息一下就好了。来吧，把头放在这里」
%ANAME(TARGET)%は太ももをポンポンと叩き、膝枕に誘う。%ANAME(MASTER)%はそれに応じ、%ANAME(TARGET)%の柔らかな太ももに頭を預ける	%ANAME(TARGET)%啪嗒啪嗒地拍大腿，邀请她枕在膝盖上。%ANAME(MASTER)%相应地将头枕在%ANAME(TARGET)%柔软的大腿上
「遠慮しなくていいぞ。%ANAME(MASTER)%だったら、これくらい何時でもしてあげるからな♥」	「不用客气哦。如果是%ANAME(MASTER)%的话，我随时都会帮你做的♥」
「尻尾に入ってみたい？　ふふ、構わないよ。さあおいで♥」	「想钻进尾巴吗？ fufu，没关系的。来吧♥」
「ん？　どうした%ANAME(MASTER)%？　マッサージしてほしいって？　ふふ、お安い御用だよ。さあ、こっちへ…」	「嗯？怎么了%ANAME(MASTER)%？你说想要按摩吗？fufu，这么简单的需求。来，过来这边…」
「さあ、リラックスして…私に全て任せてくれていいからな…♥」	「来，放松一下吧…全部交给我就好了…♥」
「ふふ…私の尻尾、いい手触りだろう？　もっと触ってくれてもいいんだぞ？」	「呵呵…我的尾巴触感很好吧？想要再摸一下吗？」
「手を繋いでくれないか？　そう、こうやって指を絡めて…♥」	「想要牵手吗？好的，像这样缠绕着手指…♥」
「ふふ、気持ち良さそうな顔…♥」	「fufu，看起来一脸舒服的样子…♥」
「…%ANAME(MASTER)%の体、たくましく感じるよ…。もう少し、このままで…いいか…？」	「…%ANAME(MASTER)%的身体，感觉很沉稳呢…再这样待会…可以吗…？」
「尻尾に入ってみたいか？　ふふ、良いとも。さあどうぞ♥」	「想钻进尾巴吗？fufu，好的。来吧♥」
「ん？　どうした%ANAME(MASTER)%。え？　マッサージしてほしい、って？」	「嗯？怎么了%ANAME(MASTER)%。啊？你说想让我按摩吗？」
「……ふふ♥　しょうがないな。それじゃあ、こっちへ…。そう、リラックスして…」	「……fufu♥没办法啊。那么，到这边来…。是的，放松一下吧…」
「尻尾でくすぐられるの、好きなのか？」	「喜欢被尾巴挠挠吗？」
「さあ、おいで♥」	「来，到这来♥」
%ANAME(TARGET)%は慈しみをこめた瞳で%ANAME(MASTER)%を手招いている	%ANAME(TARGET)%用慈爱的眼睛招手%ANAME(MASTER)%
「さあ、こっちへ…」	「来，到这边…」
「よしよし……いい子、いい子……♥」	「好吧好吧……好孩子，好孩子……♥」
%ANAME(TARGET)%は我が子を慈しむような表情で%ANAME(MASTER)%を撫でている	%ANAME(TARGET)%用慈爱的表情抚摸着%ANAME(MASTER)%
「さあ、おいで　%ANAME(MASTER)%♥」	「来吧，到这来，%ANAME(MASTER)%♥」
「私たちの間に遠慮なんているまい？　さあ、こっちへおいで…♥」	「我们之间需要客气吗？来，这边来…♥」
%ANAME(TARGET)%のふくよかな胸に抱き包められて%ANAME(MASTER)%は優しく頭を撫でられている	%ANAME(TARGET)%用丰满的胸脯所包围着%ANAME(MASTER)%，温柔地抚摸着头
「愛する人とこうしていられる時間って、とても幸せだな…♥」	「能和所爱的人在一起的时间，真是幸福啊…♥」
%ANAME(TARGET)%の甘い香りのする胸に抱き抱えられ、%ANAME(MASTER)%は頭を撫でられている	在充满着%ANAME(TARGET)%甜美香味下，%ANAME(MASTER)%被温柔地抚摸着头
「甘えてくれるととても嬉しいよ…言ってくれればいつでも撫でてあげるからな♥」	「如果能被撒娇的话我会很开心的…告诉我的话我随时都可以的♥」
%ANAME(TARGET)%に抱き抱えられ、%ANAME(MASTER)%は頭を撫でられている。%ANAME(TARGET)%の甘い香りにしばし恍惚とした	%ANAME(TARGET)%抱着%ANAME(MASTER)%的头温柔地抚摸着。沉醉在%ANAME(TARGET)%的甜蜜香味之中
「よしよし、いい子いい子…♥」	「好，好孩子好孩子…♥」
%ANAME(TARGET)%は慈しむような表情で%ANAME(MASTER)%を撫でている	%ANAME(TARGET)%用慈祥的表情抚摸着%ANAME(MASTER)%
「遠慮しなくていいんだぞ？　さあ、こっちへ…♥」	「不用客气哦？来，这边…♥」
%ANAME(TARGET)%のふくよかな胸に抱き包められて%ANAME(MASTER)%は頭を撫でられている	%ANAME(TARGET)%用丰满的胸脯所包围着%ANAME(MASTER)%并温柔地抚摸着头
「遠慮しなくていいぞ？　甘えられるときは甘えておけ♥」	「不用客气哦？该撒娇的时候就撒娇吧♥」
「よしよし、えらいえらい」	「乖 ，好孩子」
小さい子にするようなニュアンスだが、%ANAME(TARGET)%は笑顔で%ANAME(MASTER)%の頭を撫でている	虽然有点像哄小孩子的感觉，但%ANAME(TARGET)%还是笑着抚摸着%ANAME(MASTER)%的头
「撫でられたいのか？」	「想被抚摸吗？」
「撫でられたいですか？」	「想被抚摸吗？」
「ふふ、こんなに大きくして…。我慢できないんだな、仕方ないやつめ♥」	「fufu，变得这么大了…忍耐不住了吗♥　真是没办法的家伙♥」
「%ANAME(MASTER)%の精…ちょっと味見させてくれ」	「%ANAME(MASTER)%的精液…让我尝尝」
「ん…♥…ちゅぶ…♥」	「嗯…♥…啾…♥　嗯…啾…嗯♥」
%ANAME(TARGET)%はまるで飴でも舐めるかのようにしゃぶりつき、%ANAME(MASTER)%を絶頂へ誘う…	%ANAME(TARGET)%就像舔糖一样，紧紧地吸着，让%ANAME(MASTER)%走向绝顶…
「んん…♥　いくらでも飲んであげるから、たっぷり出していいぞ♥」	「嗯♥...啾…噗…♥ 多少都给你喝下去哦、满满的射出来吧~♥」
「ん…♥　ちゅ…♥　れろ…　私の口まんこに、いっぱい出してくれ♥♥」	「嗯…♥啾…♥呜…　在我的嘴里...满满的射出来吧	♥♥」
「%ANAME(MASTER)%の…とっても美味しい…♥」	「嗯...♥啾…呜…♥　%ANAME(MASTER)%的…非常好吃呢…♥」
「んちゅぅ…♥　我慢汁だけじゃ物足りないな♥」	「啊呜…啾♥…啾♥…♥　光是忍耐汁还不够啊♥」
「早く濃いの、出してくれ♥」	「嗯啊♥啾…呣♥　快点把浓浓的精液、射出来~♥」
「ん…♥　じゅ…♥　…いっぱい出していいぞ♥」	「嗯…♥啾…♥呜…再多射点出来♥」
「ふふ…我慢できないんだな♥　いいぞ…」	「fufu…忍耐不住了吗♥　行吧…」
「ちょっと味見させてもらうぞ」	「让我尝尝吧」
「もう…我慢できないのか？　ふふ、しょうがない奴だな…♥」	「已经…不能忍耐吗？fufu，真是没办法的家伙啊…♥」
「%ANAME(MASTER)%の精…ちょっと味見させてもらうぞ」	「%ANAME(MASTER)%的精液…让我尝尝」
「ん…♥　…ちゅぶ…♥」	「嗯…♥…啾…♥」
「ん…ちゅ……ふふ、もっとか？」	「嗯…啾……fufu，还想要吗？」
「ふふ。そうだな、%ANAME(MASTER)%。……うん？　どうかしたかい？」	「fufu，啊，是%ANAME(MASTER)%。……嗯？怎么了？」
%ANAME(TARGET)%は今までの事務的な様子と違い、砕けた口調で親しげに接してきた。どことなく今までより雰囲気が柔らかい…	%ANAME(TARGET)%和至今为止的事务性的样子不同，用平易近人的语调亲切地对待。总觉得气氛比以前柔和…
「ああ、もう堅苦しくするような間柄でもあるまいと思ったんだが、……馴れ馴れしかったかな？」	「啊，我想我们的关系应该不会那么拘谨了吧……是太过亲昵了吗？」
いや、これくらいの方が気楽でいい　　そう告げると%ANAME(TARGET)%はにこりと微笑んだ	不，还是这样比较轻松，我告诉%ANAME(TARGET)%道，她微笑了
「ふふ、ありがとう。私もこれくらいの方がやりやすいよ」	「fufu，谢谢。我也这样做比较轻」
「んん、…%ANAME(MASTER)%のが馴染んできたよ…♥」	「啊呜…已经好点了，可以动了%ANAME(MASTER)%…♥」
「あ゛♥あ゛ぁっ♥♥　%ANAME(MASTER)%っ♥　私も一緒に♥イ…くぅっっ♥♥♥」	「啊゛♥嗯゛哈啊♥♥%ANAME(MASTER)%~♥一起去吧♥啊…呜嗯嗯嗯嗯♥♥♥」
「ああっ♥♥　%ANAME(MASTER)%のがっ♥キたぁっっ♥♥」	「啊啊啊♥♥　%ANAME(MASTER)%的♥好厉害♥♥」
「キモチい゛い゛ぃぃ…♥♥　もっと、もっと注いでぇ♥♥」	「好舒服啊..啊…♥♥再来、更多地注入我里面吧♥♥」
「ふあっ♥♥　あ゛あっ♥♥♥　ぁへぇ…♥　%ANAME(MASTER)%と一緒にイクの…幸せぇ♥♥」	「哈啊♥♥　啊....嗯....♥♥♥嘻嘻…♥一起去了♥真是幸福呢♥♥」
%ANAME(TARGET)%は%ANAME(MASTER)%にしか見せた事が無いであろう淫蕩に耽った顔のまま、同時に達した快感で全身を痙攣させている	%ANAME(TARGET)%露出了只有%ANAME(MASTER)%能看到的痴态，同时高潮的快感让全身痉挛着
「んああっ！　あ゛あっ♥熱いぃ♥♥　%ANAME(TARGET)%の中にぃっ♥　%ANAME(MASTER)%のもっと注いでぇっ♥♥」	「嗯啊！啊，啊♥热热的♥♥ 在%ANAME(TARGET)%的小穴里♥ 再注入一点%ANAME(MASTER)%的精液吧♥♥」
中出しされて絶頂するその姿は、もはや誇り高き式神ではなくただ%ANAME(MASTER)%の子種を求める一匹の雌だ	那中出绝顶的姿态，已经不再是那骄傲的式神了，只是一个寻求着%ANAME(MASTER)%精液的雌性
精液を膣内の深くに注ぐ度、膣はきゅうきゅうと収縮し更なる快感を肉棒に与えて次の射精をねだっている…	每次精液注入阴道内深处，阴道就会突然收缩，给肉棒带来更大的快感，索求着下一次的射精…
「はあぁっ♥♥　%ANAME(MASTER)%♥　私もイクぅっ♥♥　%ANAME(MASTER)%♥大好きィっ♥♥♥♥」	「哈啊啊♥♥　%ANAME(MASTER)%♥我也要去了~♥♥　%ANAME(MASTER)%♥最喜欢了♥♥♥♥」
%ANAME(TARGET)%の蜜壷は%ANAME(MASTER)%の精液を受け止める悦びにひくつき、肉棒をきゅうきゅうと締め付ける	%ANAME(TARGET)%的蜜壶在接受%ANAME(MASTER)%的精液后被喜悦吞噬，温柔地包住肉棒
「あ゛ぁっ♥　はぁ゛っ♥♥　もっと♥　押し付けてっ♥奥に出してぇぇッッ♥♥♥」	「哈啊啊♥哈~♥♥更多♥给我更多♥射到深处去吧♥♥♥」
達すると同時に%ANAME(MASTER)%の熱い精液を受け止め、%ANAME(TARGET)%は全身を震わせて悦んでいる	达到高潮的同时接受了%ANAME(MASTER)%的炙热精液，%ANAME(TARGET)%全身喜悦地颤抖着
「あ、出たぁ！　%ANAME(MASTER)%の熱い精液来たぁっ♥♥」	「啊...出来了！　%ANAME(MASTER)%热热的精液出来了啊♥♥」
「あぁっ♥　もっと♥　出しながら腰振ってぇ♥♥♥」	「哈啊...♥呜...嗯♥♥更多♥一边射精着一边动着腰~♥嗯...♥♥」
%ANAME(TARGET)%の蜜壷は更なる精液を求めて%ANAME(MASTER)%の肉棒に絡みついてくる	%ANAME(TARGET)%的蜜壶为了寻求更多的精液而缠在%ANAME(MASTER)%的肉棒上噜咕噜地吸吮着
「ああっ♥　%ANAME(MASTER)%の、私の膣に注がれてるぅ♥♥」	「哈啊啊♥　%ANAME(MASTER)%的...注入我的小穴了~♥♥」
「もっと、もっと注いでぇ♥♥」	「嗯啊...再多注入点精液吧♥♥」
「あぁっ♥　%ANAME(MASTER)%♥大好きっ♥♥　%ANAME(MASTER)%♥♥♥」	「啊嗯♥　%ANAME(MASTER)%♥最喜欢你了♥♥　%ANAME(MASTER)%♥♥♥」
%ANAME(TARGET)%の蜜壷は更なる精液を求めて%ANAME(MASTER)%の肉棒を絞り上げてくる	%ANAME(TARGET)%的蜜壶为了寻求更多的精液而向%ANAME(MASTER)%の的肉棒吸吮来
「ああっ♥　%ANAME(MASTER)%の注がれると、おまんこ喜んじゃうのぉ♥♥」	「啊啊啊♥♥%ANAME(MASTER)%的注入我体内，感觉好开心...嘻嘻♥♥」
%ANAME(MASTER)%の前でしか見せた事が無いであろう蕩けきった顔で、%ANAME(MASTER)%の精液を搾り取っている…	%ANAME(MASTER)%露出了只在你面前出现的痴态，榨取着%ANAME(MASTER)%的精液…
「んんっ！　熱いぃ♥　もっと出してっ、もっと注いでぇっ♥♥」	「嗯啊！啊，啊♥热热的♥♥ 再多拿一点♥再注入一点吧♥♥」
中出しされて喜ぶその姿は、もはや誇り高き式神ではなくただ%ANAME(MASTER)%の子種を求める一匹の雌だ	被中出绝顶的姿态，已经不是那骄傲的式神了，只是个追求%ANAME(MASTER)%精液的一只雌性
精液を%ANAME(TARGET)%の膣内に注ぐ度に膣は収縮し、更なる快感を肉棒に与え射精を促していく…	每次把精液注入%ANAME(TARGET)%阴道深处，阴道就会收缩，给肉棒带来更大的快感，催促着射精…
「あぁっ！　…いっぱい……♥」	「啊！…满满的呢……♥♥」
「あぁっ！　…中にっ…♥」	「嗯呜！…在里面…♥」
「こんなに出して……♥」	「就这样出来吧……♥」
「んんっ！　……熱い…♥」	「啊嗯！……热热的…♥」
「んんっ！　……はぁ♥」	「啊啊嗯！……哈啊♥」
「あぁっ！　…中にっ…！」	「嗯呜！…在里面…！+」
「んんっ！　……熱い…」	「嗯呜！……热热的…」
「あ…♥」	「啊…♥」
「あっ！　…すごい勢いだな♥」	「啊！…满满的……♥」
「んっ！　……熱い…♥」	「嗯！　……热热的…♥」
「手に、これだけ出して…」	「啊、在手上出来了呢…」
「まだまだ出るだろう？　次は…どこにくれるんだ♥」	「还能继续射吧？接下来…用哪去呢~♥」
「あっ！　…すごい勢い…」	「啊！…来势汹汹啊…」
「気持ちよかったか？」	「感觉舒服吗？」
「んく……ぷはっ♥　いっぱい…♥」	「啊唔……啾♥噗哈...射的满满的呢…♥」
「んん、ちゅぅ…、気持ちよかったか？」	「啊、唔呣…、感觉舒服吗？」
「んちゅぅ……ごくっ…ぷはっ♥」	「啊唔……啾…噗啊♥」
「んん！　…ぷはっ♥　いっぱい…♥」	「嗯！…啾♥噗啊...射的满满的…♥」
「ちゅぅ…、気持ちよかったか？」	「嗯…、感觉舒服吗？」
「あぁん、んちゅぅ…ぷはっ」	「哈啊、啾…噗呜」
「んんっ！…」	「嗯！…」
「んちゅぅ…ぷはっ」	「哈啊…噗呜」
「おやおや♥　いっぱい出たな……♥」	「啊啦啊啦♥ 出来了很多呢……♥」
「胸に出したかったのか？　ふふ♥」	「想在胸部射出来嘛？　fufu♥」
「あぁ、べとべと…♥　今度は中に……♥」	「哇啊，黏糊糊的…♥　这次又忍不住射了呢……♥」
「胸で擦られるの、良かったか？　ふふ♥」	「用欧派摩擦着，舒服吗？fufu♥」
「あっ…、%ANAME(MASTER)%の精、あったかい……♥」	「哈啊…、%ANAME(MASTER)%的精液、好温暖……♥」
「あっ！……」	「啊！……」
「んっ！……」	「嗯！……」
「あらあら…♥　いっぱい出たな……♥」	「啊啦啊啦♥ 出来了很多哦……♥」
「あっ！　…もう、べとべとだよ…」	「啊！　…真是的，黏糊糊的…」
「あ……私の脚、気持ちよかったのか？」	「啊……我的脚，那么舒服吗？」
「んっ！　……凄い匂い♥」	「啊！……好浓的气味♥」
「顔に出すの、好きなのか？…♥」	「喜欢在脸上射出来么？…♥」
「んんっ！　…もう」	「啊！…嗯」
「んっ！　……凄い匂い…」	「啊！……好浓的气味…」
「髪に掛けるの好きなのか？」	「你喜欢射在头发上吗？」
「もう、髪に掛かると、落としにくいんだけど……♥」	「啊、射在头发上的话，很难清理呢……♥」
「髪に掛かると、落としにくいんだがな…」	「射在头发上的话、很难清理干净啊…」
「あっ♥　…%ANAME(MASTER)%の精、熱い……♥」	「啊嗯♥　…%ANAME(MASTER)%的精液，好烫啊……♥」
「あっ…♥もう、今度は中に出してくれ……♥」	「啊嗯 …♥呜...这次就交给我来好了……♥」
「あんっ！　…凄い匂い…」	「啊！…好厉害的气味…」
「んんっ！　……気持ちよかったか？」	「啊！……感觉舒服吗？」
「ふふ…♥　キモチよかったか？」	「fufu…♥　这么舒服吗？」
「ふふ、キモチよさそうだな…♥」	「fufu、看起来很舒服啊…♥」
「ん……♥　イっちゃったな♥」	「啊啦……♥　去了吗？♥」
「ふふ♥　とってもいい顔だぞ…♥」	「fufu♥　真是一副迷醉的样子啊…♥」
「ああっ♥♥　私の身体っ、%ANAME(MASTER)%ので♥　悦んでるっ♥♥」	「啊啊♥♥ 我的身体，被%ANAME(MASTER)%责弄着♥ 好舒服啊♥♥」
「んっ♥あっ♥いいっ♥　もっとっ、もっとぐりぐりしてぇっ♥♥」	「嗯♥哈啊♥好棒♥ 再用力一点！再激烈点也没关系哦~♥♥」
「もっとぎゅっとしてっ♥　%ANAME(MASTER)%のっ♥いっぱい出してッ♥」	「射出来♥射精♥%ANAME(MASTER)%的精液♥满满射出来吧♥」
「んっ、んんっ♥　もっと奥にっ♥　%ANAME(MASTER)%のっ♥いっぱい頂戴っ♥」	「哈、嗯嗯♥再深一点♥ %ANAME(MASTER)%的精液♥ 灌满我的小穴吧♥」
「んっ♥あっ♥　いい♥いいっ♥　中に♥中に出してぇっ♥」	「嗯♥啊♥唔♥好棒♥射在里面♥在我深处~♥」
「%ANAME(MASTER)%♥　%ANAME(MASTER)%♥　%ANAME(MASTER)%っ♥♥」	「%ANAME(MASTER)%♥%ANAME(MASTER)%♥%ANAME(MASTER)%♥♥」
「あっ！　もっとぉ♥もっと強く突いてぇっ♥」	「啊！哈啊♥再更激烈点~♥」
「%ANAME(MASTER)%っ♥　好きぃ♥　あっ、もっと頂戴っ♥」	「%ANAME(MASTER)%喜欢♥好喜欢♥啊嗯、再多给我点♥」
「あっ♥ああっ♥　%ANAME(MASTER)%のでっ♥私の中っ♥いっぱいにしてぇっ♥♥」	「啊♥啊啊♥%ANAME(MASTER)%的精液♥在我里面♥满满的射出来吧♥♥」
「あんっあっ♥　わっ、私の身体中がっ♥　%ANAME(MASTER)%の欲しがってるっ♥　もっときてぇッ♥♥」	「啊呜♥嗯，我的子宫里♥我想要%ANAME(MASTER)%的精液♥再来一点♥♥」
「もっと突いて…♥」	「再多插插我~…♥♥」
「んんっ♥　もっと奥まで…♥」	「哈啊♥再深入点…♥」
「やあっ♥　%ANAME(MASTER)%のっ♥キモチいいっ♥」	「哎呀♥%ANAME(MASTER)%的♥好舒服啊♥」
「あっこれっ♥　好きィ♥」	「啊，这个♥喜欢，喜欢~♥」
「あっあっ♥　%ANAME(MASTER)%、%ANAME(MASTER)%ぁ…♥　あっ、ぁんっ！」	「啊啊♥　%ANAME(MASTER)%、%ANAME(MASTER)%~…♥　啊、呜嗯嗯！」
「だめぇ♥　ぬいちゃだめぇ♥」	「不...♥不要...去了啊啊啊啊啊♥」
「んっ♥あっ♥　イカせてぇっ♥%ANAME(MASTER)%っ♥」	「嗯♥哈♥快给我吧♥%ANAME(MASTER)%~♥」
「あぁっ！　もっと、突いてっ♥」	「啊啊啊！再多插我吧♥」
「んっ！　んっ！　あっ、んっ♥」	「啊！嗯！啊、呜♥」
「あっ、中っ♥　キモチいい♥」	「啊、在里面♥好舒服♥」
「んっ、んっ♥　キモチいい…んんっ♥」	「啊...嗯♥好舒服…啊嗯♥」
「あっ、あっ、あんっ♥　スゴイぃっ♥」	「啊、啊、啊嗯♥好棒啊♥」
「んくっ！　そこぉ♥　あっ♥　やぁ、イっちゃっ♥」	「嗯！那里，那里♥啊♥哎呀，去了啊♥」
「んっ♥んっ、んんっ♥　もっと♥　あっ♥」	「啊♥嗯、啊呜♥更多♥嗯嗯~♥」
「あっ♥あっ♥　いいよぉ♥　あっ♥」	「啊♥哈呜♥好棒呀♥呜...♥」
「♥あっ、すごい…んんっ♥　あぁっ♥」	「♥啊，好厉害…嗯，嗯♥啊啊啊♥」
「やっ♥あっ♥あっ♥　突いて♥　もっと奥っ♥」	「啊♥啊嗯♥呜♥顶到了♥在深处里...呜呜~♥」
「これ♥好きぃ♥　あっ、あぁ、んん♥」	「这个♥喜欢，喜欢♥啊，啊，嗯呜♥~」
「あっ♥　イ♥イっちゃうっ♥♥　あっあっんん♥」	「啊♥去...♥要去了...♥♥　嗯啊啊啊啊♥」
「あぅっんっ！　…あっ…！」	「啊哼！啊…！」
「んっ！　あんっ、んんっ…。」	「嗯！啊，嗯…」
「あっ、んぁっ…んぅっ！」	「啊，呜…嗯！」
「んっいぅっ！　…ぅんっ！」	「啊呜！…呼啊啊」
「ふぅ、ふぅ…んっ…んふぅっ！」	「呼、呼…嗯…嗯哼！」
「ふやっあっ、んんっ！　はぁ…あっ」	「呼啊，嗯！哈…啊」
「やっ、あっ♥　そんな…んんっ！」	「呼、那里♥　啊…嗯！呜.....！」
「ふぅ、ふぅ…んあっ！　やぁ、声出ちゃ…んんっ！」	「呼、呼…嗯！呀、声音…呜啊啊！！」
「んっあっやっ、あっ！　そこ、…ひゃあっ！」	「嗯呜、那里！啊、…哈呜呜！」
「ふやっあっ、んんっ！　はぁ…あっ♥」	「呼啊、嗯！哈…啊~♥」
「%ANAME(MASTER)%っ♥　%ANAME(MASTER)%っ♥」	「%ANAME(MASTER)%♥%ANAME(MASTER)%♥」
「あっ♥あっ♥　ああっ♥」	「啊♥啊♥嗯啊啊♥」
「イ、イクっ！　お尻でぇっ♥」	「好...好棒啊！屁股...用屁股去了啊啊啊~♥」
「ああっ♥　お尻っ！　キモチっ♥いいっ♥」	「啊啊啊♥屁股！呜...好舒服！啊呜♥」
「あっ！　深く…ふあぁっ♥」	「哈啊！深处…啊啊啊啊♥」
「こ、こんなとこでっ♥キモチよく…っ♥」	「这、就是那里♥感觉好舒服…噫呜呜~♥」
「んっ！　あっ♥お尻っ♥イイっ！」	「啊！哈啊♥屁股...♥去了啊啊啊！」
「ふやっあっ、んんっ！　はぁ…あっ！」	「呼啊，嗯！哈…啊！」
「お尻で…こんなに…っ」	「用屁股…这么的…嗯」
「あっ、あっ！　ああっ！」	「哈，啊！啊！」
「ああっ！　お尻っ！　深っ…あぁっ！」	「啊！屁股！里面…啊啊！」
「あぁっ！　こんなところで…っ」	「啊啊！在这种地方…嗯」
「あっ！　深く…ふあぁっ！」	「啊！里面啊…啊啊啊！」
「こ、こんなとこでっ、感じ…っ」	「这、这样的地方、感觉…嗯」
「んっ！　あっ、お尻ぃっ」	「嗯！啊，屁股啊」
